Samskrit Word	Samskrit_GenderTelugu	Telugu_Word	Telugu _Gender																						
BIma	puM	BImudu	puM																						
Esvarya	napuM	ESvaryaM	napuM																						
ISvara	puM	ISvarudu	puM																						
pramuKa	puM:napuM	pramuKaM	napuM:napuM																						
ABaraNa	napuM	ABaraNaM	napuM																						
ABAsa	puM:napuM	prakASaM	napuM:napuM																						
aBAva	puM	aBAvaM^lekapovadaM	napuM																						
aBaya	napuM:puM	aBayaM^BayaM_lekapovadaM	napuM:napuM																						
aBi-asUyaka	puM:napuM	asUya_kalavAdu	puM:puM																						
aBiBava	puM:napuM	wiraskAraM^parABavaM	napuM:napuM																						
aBikrama	puM	prAraMBaM	napuM																						
aBimAna	puM	aBimAnaM^prema	napuM																						
aBimuKa	puM:napuM	aBimuKaM^exuruga	napuM:napuM																						
aBipravqwwa	puM	paniyaMxu_nimagnudu	puM																						
aBirakRa	napuM:puM	rakRiMpabadu	napuM:napuM																						
aBiRvafga	puM	aBiruci^awyAsakwi^sparSa	napuM																						
aBisanXa	puM	vaFcakudu^niMxakudu	puM																						
aBra	napuM	AkASaM^meGaM	napuM																						
aByanwara	napuM	maXya^lopala	napuM																						
aByAsa	puM	aByAsiMcadaM^malYlYi_malYilYi_ceyadaM	napuM																						
aByAsa	puM	aByAsaM^alavAtu	napuM																						
aByasana	napuM	aByAsaM	napuM																						
aByuwWAna	napuM	aBivqxXi^perugadaM	napuM																						
acalA	swrI:vi	acalamEnaxi^BUmi^parvawaM	napuM																						
acala	puM:napuM:vi	acalamEnaxi^BUmi^parvawaM	napuM:napuM																						
AcAra	puM	AcAraM	napuM																						
acara	puM:napuM:vi	sWiraM^acaraM	napuM:napuM																						
AcAra	puM	AcaraNaM^vyavahAraM	napuM																						
AcArya	puM	AcAryudu	puM																						
acinwya	puM:napuM:vi	AlociMcalenixi	napuM:napuM																						
acira	napuM	aciraM^cirakAlaM_kAnixi	napuM																						
acyuwa	puM:vi	ViRNuvu	puM																						
acyuwa	puM:vi	sWiramEnaxi	napuM																						
afga	napuM:puM	aMgaM	napuM:napuM																						
aFjali	swrI	aFjali^cewulu_jodiMci_namaskariMcuta	napuM																						
aGa	napuM:puM	pApaM^aparAXaM	napuM:napuM																						
Agama	puM	Agama	napuM																						
Agama	puM	Agama_SAswraM	napuM																						
agni	puM	agni	napuM																						
agra	napuM:puM	agraM^eVxuta^muKyaM^moVxatixi	napuM:napuM																						
agra	napuM:puM	moVxatixi^muKyaM	napuM:napuM																						
ahafkAra	puM	ahaMkAraM	napuM																						
ahafkqwa	puM	ahaMkAraM_kalavAdu	puM																						
ahaH	napuM	pagalu	napuM																						
vAxin	puM:napuM	vakwa	puM:napuM																						
ahan	napuM	xinaM^sUryudu^pagalu	napuM																						
AhAra	napuM:puM	AhAraM^BojanaM	napuM:napuM																						
AhAra	napuM:puM	AhAraM^apaharaNaM	napuM:napuM																						
Ahava	puM	yuxXaM^yajFaM	napuM																						
ahiMsA	swrI	ahiMsa	napuM																						
aja	puM	janmiMcanixi	napuM																						
ajasram	puM:napuM	eVllappudu^niwyaM	napuM:napuM																						
ajaya	puM:napuM	parAjayaM^ajayaM	napuM:napuM																						
ajFa	puM	mUrKudu^ajFAni	puM																						
ajFAna	napuM	ajFAnaM	napuM																						
sammoha	puM	AkarRaNa	napuM																						
ajina	puM:napuM	carmaM	napuM:napuM																						
Ajya	napuM	AjyaM^neVyyi	napuM																						
AkAfkRin	puM:napuM	AsiMcuvAdu^koruvAdu	puM:puM																						
akAra	puM	akAraM	napuM																						
akAra	puM	pani_ceyanivAdu	puM																						
akArya	napuM:puM	ceVddapani	napuM																						
AkASa	napuM:puM	AkASaM	napuM:napuM																						
aKila	napuM	samagraM^aMwayu^saMpUrNaM	napuM																						
Akqwi	swrI	Akqwi^rUpaM	napuM																						
akRara	napuM	akRaraM	napuM																						
akRaya	puM	kRINiMcanixi^kRayaM_lenixi	napuM																						
akRi	napuM	newraM^kannu	napuM																						
akroXa	puM	kroXaM_lenivAdu	puM																						
Akula	napuM	kRoBa^AkulaM	napuM																						
alasa	puM:napuM:vi	somari	puM:puM																						
Alasya	napuM	alasawvaM	napuM																						
Alaya	puM	AlayaM^nivAsaM	napuM																						
alolupa	puM:napuM	nirASAparudu	puM:puM																						
alpa	napuM	alpaM^wakkuva	napuM																						
amala	napuM:puM:swrI	SuxXaM^paviwraM	napuM:napuM:napuM																						
amAnin	napuM	vinayaM	napuM																						
amarRa	puM	asahanaSIlaM^kopaM	napuM																						
Amaya	puM	rogaM	napuM																						
amBas	napuM	uxakaM^nIru^AkASaM	napuM																						
ambu	napuM	jalaM^nIru	napuM																						
ameXya	puM:napuM:vi	malinaM^apaviwraM	napuM:napuM																						
Amla	puM:napuM	pulupu	napuM:napuM																						
amqwa	napuM:puM	amqwaM^suXa	napuM:napuM																						
aMSa	puM	aMSaM	napuM																						
anaGa	puM:napuM:vi	nirxoRaM^nirmalaM	napuM:napuM																						
anala	puM	agni^jaTarAgni	napuM																						
anAmaya	puM	ArogyaM	napuM																						
ananwA	swrI	anaMwaM	napuM																						
ananwa	puM	anaMwaM	napuM																						
ananwara	napuM	anaMwaraM	napuM																						
ananya	puM:napuM:vi	ananya^samarUpaM^aBinnaM	napuM:napuM																						
anArya	puM:napuM	xuRtudu	puM:puM																						
anAxi	puM	anAxi^niwyaM	napuM																						
aneka	napuM:puM	anekaM	napuM:napuM																						
anIka	napuM:puM	sEnyaM	napuM:napuM																						
anikewa	puM:napuM:vi	sanyAsi^nivAsa_hInudu	puM:puM																						
anirxeSya	puM:napuM:vi	anirxeSyaM^nirxeSiMcalenixi	napuM:napuM																						
aniwya	puM:napuM:vi	aniwyaM	napuM:napuM																						
aNIyas	puM:napuM:vi	sUkRmaM^cAlA_koVMceM	napuM:napuM																						
aniyawa	puM:napuM:vi	niyamaM_lenixi	napuM:napuM																						
anna	napuM	annaM^AhAraM	napuM																						
aNu	puM:vi	aNuvu^koVMceM	napuM																						
anubanXa	puM	anubaMXaM^pASaM	napuM																						
anugraha	napuM:puM	anugrahiMcuta^xaya_cUputa	napuM:napuM																						
anukampA	swrI	karuNa^xaya	napuM																						
anuRTiwa	napuM:puM	AcariwaM	napuM:napuM																						
anurUpA	swrI	anurUpaM^anuguNaM^samAnamEna	napuM																						
anuwwamA	swrI	SreRTurAlu^sarvowwamurAlu	swrI																						
anuwwama	puM	SreRTudu^sarvowwamudu	puM																						
anuxarSana	napuM	xaggaragA_cUdadaM^nirIkRiMcadaM	napuM																						
anwa	napuM:puM	aMwaM	napuM:napuM																						
anwara	puM:napuM	aMwaraM^samIpaM^lopala	napuM:napuM																						
anwarAwman	puM	aMwarAwma^paramAwma	napuM																						
anwika	napuM:puM	samIpaM^anwaM	napuM:napuM																						
anyA	swrI	anyaM^veru^iwaraM^BinnaM	napuM																						
anya	napuM:puM	anyaM^veru^iwaraM^BinnaM	napuM:napuM																						
anyAya	puM	anyAyaM^nyAyaM_lenixi	napuM																						
ap	swrI	jalaM	napuM																						
apamAna	napuM:puM	anAxaraNa	napuM:napuM																						
apAna	puM	apAna_vAyuvu	napuM																						
aparA	swrI	iwaraM^waruvAwa	napuM																						
apara	napuM:puM	iwaraM^waruvAwa	napuM:napuM																						
aparAjiwa	puM	ajeyudu	puM																						
aparaspara	puM:napuM	parasparaM_kAnixi	napuM:napuM																						
aparigraha	puM	svIkariMcakapovuta^saMgrahaNa_icca_lekapovuta	napuM																						
apAwra	puM	apAwrudu^xAnamunaku_pAwrudu_kAnivAdu	puM																						
apAyin	puM	apAyaM	napuM																						
apESuna	napuM	sawyaM^nyAya_buxXi	napuM																						
apohana	napuM	Uha^BrAMwi^woVlagiMcadaM	napuM																						
aprakASa	napuM:vi	prakASaM_lenixi^prakatiMpabadanixi	napuM																						
apravqwwi	swrI	pravqwwi_lenixi^nivqwwi	napuM																						
aprawima	napuM	asamAnudu	puM																						
aprawiRTa	puM:napuM:vi	aprawiRTa	napuM:napuM																						
apriya	napuM:puM:swrI	apriyaM	napuM:napuM																						
apunarAvqwwi	swrI	maroVka_janma_lenixi^mukwi	napuM																						
ApUryamANa	puM	aMwatA_vyApiMcunaxi	napuM																						
apyaya	puM	nASaM	napuM																						
arAga	puM:napuM	rAga_rahiwa	napuM:napuM																						
ArAma	puM	wota^upavanamu^AnaMxamu^krIdA_praxeSamu	napuM																						
AramBa	napuM:puM	AraMBaM	napuM:napuM																						
ArAXana	napuM	ArAXana	napuM																						
arha	puM:napuM	arhawa	napuM:napuM																						
arha	puM:napuM	waginavAdu	puM:puM																						
ari	puM	Sawruvu	puM																						
arisUxana	puM	arisUxanudu^Sawqvulanu_nASamu_ceyuvAdu	puM																						
Arjava	napuM	saralYawa^nijAyiwI	napuM																						
arjuna	puM	arjunudu	puM																						
arka	puM	sUrya_kAMwi	napuM																						
Arogya	puM:napuM	Arogyamu	napuM:napuM																						
arpaNa	napuM	arpaNamu^samarpaNamu	napuM																						
ArurukRu	puM	unnawi_ceVMxavaleVnani_icca_kalavAdu	puM																						
Arwa	napuM:puM	xuHKamu	napuM:napuM																						
arWa	puM	arWamu^vaswuvu^Xanamu^prayojanamu	napuM																						
arWin	puM:napuM	Xanikudu^arWiMcuvAdu^yAcakudu	puM:puM																						
arWIya	puM:napuM	aBiprAyaM_kalavAdu	puM:puM																						
aryaman	puM	sUryudu^piwqxevawa	puM																						
ASa	napuM	ASa	napuM																						
Asafga	puM:napuM	ASrayaM^anurAgaM^sAhacaryaM	napuM:napuM																						
Asakwa	napuM:puM	sWirudu^Asakwudu	puM:puM																						
asakwa	puM:napuM	Asakwi_lenivAdu	puM:puM																						
asakwi	swrI	Asakwi_lekapovadaM	napuM																						
asamarWa	napuM:puM:swrI	asamarWawa	napuM:napuM:napuM																						
asaMSaya	napuM:puM	saMSayamu_lenixi	napuM:napuM																						
asaMyawAwman	puM	iMxriya_nigrahamu_lenivAdu	puM																						
Asana	napuM	Asanamu^pIta	napuM																						
aSAnwa	puM	aSAMwi	napuM																						
ASApASa	puM	ASA_baMXaM	napuM																						
asaw	puM:napuM	nijamu_kAnixi^xuRtudu	napuM:puM																						
asawya	napuM	asawyamu	napuM																						
ASaya	puM	nivAsa_sWAnaM	napuM																						
AScarya	napuM:puM	AScaryamu	napuM:napuM																						
aSeRa	vi:puM:napuM	aSeRamu^aKilamu^saMpUrNamu	napuM																						
aSin	puM	ciraMjIvi	puM																						
asiwa	puM	nalupu^nIlamu^Sani_grahamu^weVlupu_kAnixi	napuM																						
asixXi	swrI	asaMpUrNamu	napuM																						
aSman	puM	rAyi^meGaM	napuM																						
asmaxIya	napuM	mana	napuM																						
Asraya	napuM:puM	ASrayamu^nivAsamu^AXAramu	napuM:napuM																						
aSru	napuM	kannIru	napuM																						
ASu	napuM	wvaraga^veVMtane	napuM																						
asu	napuM	SvAsa	napuM																						
asu	napuM	prANamu	napuM																						
aSuBa	napuM:puM:swrI	aSuBamu	napuM:napuM:napuM																						
aSuci	swrI:vi	aSuci^aSuxXamu	napuM																						
Asura	puM	Asura^rAkRasa	puM																						
asura	puM	asurudu^rAkRasudu	puM																						
asUyu	napuM	asUyAparudu	puM																						
aSva	puM	aSvamu	napuM																						
aSvawWa	puM	rAvi_cettu	napuM																						
aSvawWAman	puM	aSvawWAma	puM																						
aSvin	puM	aSva_pAlakudu^rOwu	puM																						
Aswikya	napuM	AswikawvaM	napuM																						
asWira	napuM	sWiramu_kAnixi	napuM																						
avaboXa	puM	melukoVlpadaM^nerpiMcadaM	napuM																						
avAcya	puM:napuM	ceVdu_mAta	napuM:napuM																						
avagama	puM	samIpiMcadaM^weVlusukonadaM	napuM																						
avahAsa	puM	cirunavvu	napuM																						
avara	napuM:puM	paScima^nIcamEnaxi	napuM:napuM																						
avaSa	puM	vaSamu_kAnixi	napuM																						
avaSa	puM	parAXInudu^svawaMwrudu	puM																						
Avqwwi	swrI	paryAyamu	napuM																						
avyaya	puM:napuM	avyayamu	napuM:napuM																						
awanxriwa	puM	jAgrawa_kalavAdu	puM																						
awapaska	puM	wapassu_vismariMcuvAdu	puM																						
AwawAyin	puM	SaswraprahAramu_ceyuvAdu	puM																						
awinIca	puM:napuM	awinIcaM	napuM:napuM																						
awInxriya	puM:napuM	prawyakRamu_kAnixi	napuM:napuM																						
awIwa	napuM:puM	awIwaM^gadacinaxi	napuM:napuM																						
AwmA	puM	Awma	napuM																						
Awmaka	puM:napuM	svaBAva	napuM:napuM																						
Awman	puM	Awma	napuM																						
Awmavaw	napuM:puM	Awma_jFAni^svasWa_ciwwudu	puM:puM																						
awyanwa	puM	awyaMwamu	napuM																						
Awyanwika	puM	awyaXikamu^aMwamu_lenixi	napuM																						
awyarWa	puM	awyaXikamu^awyanwamu	napuM																						
awyuRNa	puM:napuM	eVkkuva_vedi^xahiMcunaxi	napuM:napuM																						
aXamA	swrI	aXamurAlu	swrI																						
aXama	puM:napuM	aXamudu	puM:puM																						
axamBin	napuM	kapatamu_lekapovadaM	napuM																						
aXarma	puM	aXarmamu	napuM																						
AxarSa	puM	AxarSamu	napuM																						
axBuwa	napuM:puM	axBuwamu	napuM:napuM																						
Axi	puM:napuM	Axi^moVxalagu	napuM:napuM																						
aXiBUwa	napuM	parabraHmA^brahmamu	napuM																						
aXika	napuM:puM	aXikamu	napuM:napuM																						
aXikAra	puM	aXikAramu	napuM																						
Axin	puM:vi	BujiMcevAdu	puM																						
aXipa	puM	aXipawi	puM																						
AXipawya	napuM	Axipawyamu	napuM																						
aXiRTAna	napuM	AkramiMcuta^sWiramuga_uMduta	napuM																						
Axiwya	puM:puM	Axiwya	napuM:napuM																						
Axiwyavaw	puM:napuM	Axiwyudi_lAgA	puM:napuM																						
aXixEva	puM	aXixevawa	puM																						
aXixEvawa	napuM	aXixevawa	puM																						
aXiyajFa	puM:napuM	muKya_yAgamu	napuM:napuM																						
Axya	napuM:puM	Axyamu	napuM:napuM																						
aXyakRa	napuM:puM	aXyakRudu^aXikAri	puM:puM																						
aXyAwma	napuM:puM	aXyAwma^Awma_saMbaMXamEna	napuM:napuM																						
ayajFa	puM	yajFamu_kAnixi	napuM																						
ayana	napuM	ayanamu^gamanamu^mArgamu	napuM																						
AyAsa	napuM:puM	prayAsa^prayawnamu^Srama	napuM:napuM																						
ayawi	puM	yawi_kAnivAdu	puM																						
ayoga	puM	veru_ceyadaM^ayogyawa	napuM																						
Ayus	napuM	Ayuvu^jIviwa_kAlamu^AyuRRu	napuM																						
AyuXa	napuM	AyuXamu	napuM																						
BAga	napuM:puM	BAgamu	napuM:napuM																						
Bagavaw	napuM:puM	BagavaMwudu^ISvarudu	puM:puM																						
bAhu	puM	Bujamu	napuM																						
bahula	puM:napuM	bahulamu	napuM:napuM																						
bahuviXa	napuM:puM	bahuviXamuluga	napuM:napuM																						
bAhya	napuM:puM	bAhyamu^veVlupala	napuM:napuM																						
Bakwa	puM	Bakwudu	puM																						
Bakwi	swrI	Bakwi	napuM																						
Bakwimaw	puM	Bakwudu^Bakwi_kalavAdu	puM																						
bala	napuM:puM	balamu	napuM:napuM																						
bAla	napuM:puM	bAla^bAludu	puM:puM																						
bala	napuM:puM	balamu	napuM:napuM																						
banXa	puM	baMXamu^baMXanamu^SarIraM	napuM																						
banXana	napuM	banXanaM^kattu	napuM																						
banXu	puM	baMXuvu	puM																						
BARA	swrI	BARa	napuM																						
BArawa	napuM	BArawa^Barawa_xeSaM	napuM																						
BarawarRaBa	puM	BarawarRaBa^BarawaxeSa_rAju	puM																						
Barawasawwama	puM	Barawasawwama^BarawaSreRTa	puM																						
BarawaSreRTa	puM	Barawa_SreRTudu	puM																						
Barwq	puM	Barwa^rAju^praBuvu	puM																						
BAva	puM	BAvaM^manovikAramu	napuM																						
Bava	puM	Bava^prApwi^janmamu	napuM																						
BAvanA	swrI	BAvana^Alocana	napuM																						
Bavana	napuM	Bavanam	napuM																						
Bavaw	napuM:puM	jarugunaxi^uMdunaxi	napuM:napuM																						
BaviRya	puM	BaviRya^kAgalaxi	napuM																						
bawa	puM	Sokamu^xuHKamu^AScaryamu	napuM																						
Baya	napuM	Bayamu	napuM																						
BayAnaka	puM:napuM	BayAnakamu^BayaMkaramu	napuM:napuM																						
BayAvaha	puM	BayAvaha^Bayamunu_kaligiMcunaxi	napuM																						
BEkRya	napuM	BikRa^BikRA_samUhamu	napuM																						
BerI	swrI	BerI	napuM																						
Bexa	puM	Bexamu	napuM																						
bIja	napuM	bIjamu	napuM																						
BinnA	swrI	Binnamu	napuM																						
BIRma	puM:napuM	BIRmudu^BayaMkara	puM:napuM																						
BIwa	napuM:puM	BIwa^Bayamu	napuM:napuM																						
Boga	napuM:puM	Bogamu^suKaM	napuM:napuM																						
Bogin	puM	Bogi^suKI^Bogamu_anuBaviMcuvAdu	puM																						
Bojana	napuM	Bojanamu	napuM																						
Bokwq	napuM	Bogi^rAju^BujiMcuvAdu	puM																						
Bokwqwva	napuM	anuBaviMcuta	napuM																						
Bqgu	puM	Bqgu_maharRi	puM																						
bqhaw	napuM:puM:swrI	goppaxi^pexxaxi	napuM:napuM:napuM																						
Bqw	puM	BariMcuvAdu^baMtu^kUli	puM																						
brahma	puM:napuM	brahma	puM:puM																						
brahmacArin	napuM	brahmacAri	puM																						
brahmacarya	napuM	brahmacaryamu	napuM																						
brahman	napuM:puM	brahman^paramAwma	napuM:napuM																						
brahman	napuM:puM	brahmamu	napuM:napuM																						
brAhmaNa	puM	brAhmaNudu	puM																						
brAhmI	swrI	sarasvawi	swrI																						
brAhmI	swrI	vAkku	napuM																						
BraMSa	puM	naSiMcuta^kriMxapadadaM	napuM																						
BrAwq	puM	sahoxarudu^wodabuttinavAdu	puM																						
BrU	swrI	kanubomma	napuM																						
Buja	puM	Bujamu	napuM																						
BUmi	swrI	BUmi	swrI																						
BUwi	swrI	BUwi^BAgyamu^ESvaryamu	puM																						
buXa	puM	buXudu^paMdiwudu	puM																						
buxXi	swrI	buxXi^mawi^meXassu	napuM																						
Buyas	napuM	marala^malYli	napuM																						
caFcala	puM	caFcalamu	napuM																						
caFcala	napuM	caFcalaM	napuM																						
cakra	puM	cakramu	puM																						
cakrin	puM	cakri^cakramu_XariMcuvAdu^viRNuvu^kummari	napuM																						
cakRus	napuM	cakRuvu^kannu^newramu	napuM																						
cakRus	napuM	kannu^newraM	napuM																						
Cala	napuM	mosamu^vaMcana	napuM																						
cala	napuM:puM	cala^kaxaluta	napuM:napuM																						
camU	swrI	sena	napuM																						
Canxas	napuM	Canxassu^icca	napuM																						
canxramas	puM	caMxrudu	napuM																						
cAnxramasa	puM	cAMxramAsa^caMxruniwo_lekkiMcu_mAsamu	napuM																						
cApa	napuM	Xanussu	napuM																						
cApala	napuM	capalaM	napuM																						
cara	napuM:puM:swrI	caramu^kaxulunaxi^wirugunaxi	napuM:napuM:napuM																						
carAcara	puM:napuM	carAcara	napuM:napuM																						
cArin	napuM:puM	AcariMcuvAdu^saMcariMcuvAdu	puM:puM																						
cawur	puM:swrI	cAwuryamu^nAlugu	napuM																						
cawur	puM:swrI	cAwuryamu^nAlugu	napuM:napuM																						
cAwurvarNya	napuM	cawurvarNamulu	napuM																						
cawurviXa	puM:napuM	nAlugu_viXamuluga	napuM:napuM																						
cekiwAna	puM	cAndramAsa	napuM																						
cEla	puM:napuM	vaswramu	napuM:napuM																						
ceRtA	swrI	ceRta	napuM																						
cewanA	swrI	cewanamu	napuM																						
cewas	napuM	ciwwamu^cewanamu^manassu	puM																						
cikIrRu	puM	ceya_icca_kalavAdu	puM																						
cikIrRu	puM	ceyavaleVnani_icca_kalavAdu	puM																						
Cinna	napuM:puM	Cinna^Cexana	napuM:napuM																						
cinwA	swrI	ciMwa^walapu^xigulu^Alocana	napuM																						
cira	napuM	cira_kAlaM^cAlA_kAlaM^pAwa	napuM																						
ciwraraWa	puM	sUryudu	puM																						
ciwwa	napuM:puM	ciwwamu	napuM:napuM																						
ciw	puM:napuM	manassu	napuM:napuM																						
wawva	napuM	wawvaM	napuM																						
coxanA	swrI	prerepiMcuta	napuM																						
eka	napuM:puM:swrI	oVkati	napuM:napuM:napuM																						
ekAgra	puM	ekAgrawa	puM																						
ekAkin	puM	ekAki	napuM																						
ekAnwa	napuM:puM	ekAMwamu	napuM:napuM																						
ekawva	napuM	aBexamu^oVkatigA_uMduta	napuM																						
ErAvawa	puM	ErAvawamu	napuM																						
ESvara	puM:napuM	ISvaruniki_saMbaMXiMcinaxi	napuM:napuM																						
eXas	napuM	iMXanamu^samiXa	napuM																						
gahanA	swrI	xattamEna^guha^kaRtamu	puM																						
gajenxra	napuM:puM	gajeMxrudu	puM:puM																						
gAmin	puM:napuM	velYluvAdu	puM:puM																						
gamya	puM:napuM	poMxawaginaxi	napuM:napuM																						
gaNa	puM	gaNamu^samUhamu^vargamu	napuM																						
gANdIva	puM	gANdIvamu	napuM																						
ganXa	puM:napuM	ganXamu^vAsana	napuM:napuM																						
ganXarva	puM	ganXarvudu	puM																						
garBa	puM	garBamu	napuM																						
garIyas	napuM	GanamEnaxi	napuM																						
gawa	puM:napuM	gawa^gawiMcinaxi	napuM:napuM																						
gawi	swrI	gawi^calanamu^poka^gamanaM	napuM																						
gAwra	napuM	avayavamu^SarIramu	napuM																						
gaxgaxa	puM:napuM	gaxgaxa	napuM:napuM																						
gaxin	puM:napuM	gaxAXAri	puM:puM																						
gAyawrI	swrI	gAyawri	swrI																						
geha	napuM	gqhamu^illu^SarIramu	napuM																						
glAni	swrI	alasata	napuM																						
go	puM:swrI	Avu	napuM																						
gocara	napuM:puM	gocaramu	napuM:napuM																						
gomuKa	puM:napuM	gomuKaM	napuM:napuM																						
gopwq	napuM	rakRakudu^rAju	puM																						
GoRa	napuM:puM	GoRa^Xvani	napuM:napuM																						
Gora	napuM:puM	GoramEnaxi^BayaMkaramu	napuM																						
govinxa	puM	goviMxa	puM																						
gqha	napuM	gqhaM^illu	napuM																						
grAha	puM:napuM	grahiMcadaM	napuM:napuM																						
grAha	puM:napuM	grahiMcuvAdu	puM:puM																						
grAhya	puM:napuM	grahiMpawaginaxi	napuM:napuM																						
grAma	puM	grAmamu^samUhaM	napuM																						
GrANa	napuM	vAsana^nAsika	napuM																						
grasiRNu	napuM	winuvAdu^mriMguvAdu	puM																						
grIva	puM	kaNTamu	napuM																						
gudAkeSa	puM	arjunudu	puM																						
guhya	napuM:puM:swrI	guhyamu^rahasyamu	napuM:napuM:napuM																						
guNa	puM:napuM	guNamu	napuM																						
guNamaya	napuM:puM	saxguNamulu_kalavAdu	puM																						
guNamayI	swrI	saxguNamulu_kalaxi	swrI																						
guru	puM	guruvu	puM																						
guru	puM	baruvu^muKyamu	napuM																						
han	puM:napuM	vaXiMcuta	napuM:napuM																						
hAni	swrI	hAni	puM																						
hanwq	puM	hiMsiMcuvAdu	puM:puM:puM																						
hara	napuM:puM:puM	Sivudu^hariMcuvAdu	puM:puM:puM																						
hari	puM	hari	puM																						
harRa	puM	harRamu	napuM																						
harRaNa	puM:napuM	harRaM	napuM:napuM																						
haswa	puM	haswamu	napuM																						
haswin	puM	woVMdamu_kalaxi^enugu	napuM																						
havis	napuM	havis^homa_xravyamu	napuM																						
haya	puM	hayamu^gurramu	napuM																						
hewu	puM	hewuvu^kAraNamu	napuM																						
hEwuka	napuM:puM	hewuvAxamu_kalavAdu	puM:puM																						
hEwuka	napuM:puM	hewuvAxi	puM:puM																						
himAlaya	puM	himAlayamu	napuM																						
hiMsA	swrI	hiMsa	napuM																						
hqRIkeSa	puM	hqRIkeSudu^viRNuvu	puM																						
hqw	puM:napuM	hariMcunaxi	napuM:napuM																						
hqx	napuM	manassu^hqxayamu^CAwi	napuM																						
hqxaya	napuM:puM	hqxayamu	napuM:napuM																						
hqxya	napuM	manassuku_hiwamEnaxi	napuM																						
hrI	swrI	siggu^lajja	napuM																						
huwASa	puM	agni	napuM																						
icCA	swrI	icCa^iRtamu^korika	napuM																						
samuwWa	puM:napuM	uxBaviMcadaM^pEki_leVgavadaM	napuM:napuM																						
ijya	puM:napuM	guruvu^xevawa^pUja	puM:puM																						
ijyA	swrI	yAgamu^xAnamu	napuM																						
IkRaNa	puM	cUpu^xqRti	napuM																						
ikRvAku	puM	ikRvAku_vaMSaM	napuM																						
inxriya	napuM	inxriyamulu^wvagAxi_inxriyamulu	napuM																						
inxriyArWa	puM	inxriya_viSayamu	napuM																						
Xuk	puM	piMdadaM	napuM																						
iRu	puM	bANamu	napuM																						
iRvAsa	puM	vilukAdu	puM																						
iRvAsa	puM	villu^Xanussu	napuM																						
ISa	puM	ISa^ISvarudu^sqRtikarwa	puM																						
ISvara	puM	Isvarudu	puM																						
iwara	puM	iwara	napuM																						
IxqS	napuM:puM:swrI	I_viXaMga	napuM:napuM:napuM																						
jafgama	puM	jIviwa^wirugunaxi	napuM																						
jaGanya	napuM:puM	civarixi^nIcudu^aXamudu	napuM:puM																						
jagaw	napuM:puM	jagawwu^lokaM^prapaMcaM	napuM																						
jAhnavI	swrI	jAhnavI^gaMga	swrI																						
jAla	napuM	jAlaM	napuM																						
jana	puM	janaM	puM																						
janaka	puM	janakudu	puM																						
janArxana	puM	janArxanudu^viRNuvu	puM																						
janman	napuM	uwpawwi^puttuka^uxBavamu	napuM																						
janwu	puM	janwuvu	napuM																						
japa	puM	japamu	napuM																						
JaRa	napuM:puM	cepa^adavi	napuM:napuM																						
jarA	swrI	musaliwanamu^muximi	napuM																						
jAwi	swrI	kulamu^puttuka^sAmAnyamu	napuM																						
jaya	napuM:puM:swrI	jayamu	napuM:napuM:napuM																						
jayaxraWa	puM	jayaxraWudu	puM																						
jFAna	napuM	jFAnamu	napuM																						
jFAnin	puM	jFAni	napuM																						
jijFAsu	puM	welusukonu_icCa_kalavAdu	puM																						
jIrNa	napuM:puM:swrI	jIrNa^vqxXudu^SiWilamu^pAwaxi	napuM:napuM:napuM																						
jIva	napuM:puM	jIvamu^prANaM	napuM:napuM																						
jIvana	napuM	jIvanamu^brawuku_weruvu	napuM																						
juRta	napuM:puM	saMwoRaM^yukwamu	napuM:napuM																						
jvalana	napuM:puM	prakAsiMcunaxi^maMta	napuM:napuM																						
jvara	puM	jvaraM	napuM																						
jyAyas	napuM:puM	SreRTudu^agrajudu^vqxXudu	puM:puM																						
jyAyasI	swrI	SreRTurAlu^agrajurAlu^vqxXurAlu	swrI																						
jyowis	napuM:puM	jyowi^prakASamu^agni^velugu	napuM:napuM																						
Ka	puM	AkASamu	napuM																						
kAFcana	napuM	koMceM	napuM																						
kAfkRin	puM	kAfkRiMcuvAdu	puM																						
kAla	napuM:puM	kAlamu^samayamu	napuM																						
kalevara	napuM:puM	kalevaraM^SarIraM	napuM:napuM																						
kalila	napuM:puM	aCexya^xattamEna	napuM:napuM																						
kalmaRA	swrI	kalmaRamu^pApamu	napuM																						
kalmaRa	napuM:puM	kalmaRaM^malinaM	napuM:napuM																						
kalpa	puM:napuM	vexAfgaM	napuM:napuM																						
kRaya	puM:napuM	nASamu^kRayamu	napuM:napuM																						
kalyANa	puM:napuM	maMgalYapraxaM^lABaxAyakaM	napuM:napuM																						
kqw	puM:napuM:swrI	ceyadaM	napuM:napuM:napuM																						
kAma	puM:napuM	kAmaM^korika^icCa	napuM:napuM																						
kAmakAra	puM	yaWeRtaMgA_pravarwiMcuvAdu	puM																						
kamala	puM:napuM	kamalaM	napuM																						
Asana	napuM	AsanaM	napuM																						
pawra	napuM	pawraM	napuM																						
akRa	puM:napuM	kannu^newraM	napuM																						
kAmin	puM:puM	kAmiMcuvAdu^korika_kalavAdu	puM																						
kAmyA	swrI	kAmyamu^korika	napuM																						
kAmya	napuM:puM	korika^koraxaginaxi	napuM:napuM																						
kanxarpa	puM	manmaWudu	puM																						
kapila	puM	kapila_varNaM	napuM																						
kapi	puM:swrI	kapi^kowi^enugu	napuM:napuM																						
Xvaja	puM	XvajaM^jaMda	napuM																						
kara	puM	kara^ceyuvAdu	puM																						
kAraka	napuM:puM	karwa	puM:puM																						
karAla	napuM:puM	BayAnakamu^BayaMkara^viswqwa	napuM:napuM																						
kAraNa	napuM	kAraNamu^sAXanamu^hewuvu	napuM																						
karaNa	napuM	kriya^Xarmika_kqwyaM	napuM																						
karmajA	swrI	karmalanuMci_puttinaxi	napuM																						
karmaja	napuM	karmalanuMci_puttinaxi	napuM																						
karman	napuM:puM	karma^pani_ceyadaM^kAryaM	napuM																						
karmin	puM	pani_ceyuvAdu	puM																						
karNa	puM	karNudu	puM																						
kArpaNya	napuM	kqpaNawvaM	napuM																						
karuNa	napuM:puM	karuNa^kanikaramu	napuM:napuM																						
karwq	puM	sqRti_karwa^ceyuvAdu	puM																						
kArya	napuM:puM	kAryaM^pani	napuM:napuM																						
kASirAja	puM	kAsirAju	puM																						
kaSmala	napuM:puM	malinaM^kaSmala^pApamu^aSuxXaM	napuM:napuM																						
kASya	napuM	kASi_rAjyapu	napuM																						
katu	napuM	gAtu^kAramu	napuM																						
kavi	puM	kavi^paMdiwudu	puM																						
kAya	napuM:puM	kAyamu^Sariramu^kAya	napuM:napuM																						
keSava	puM	keSavudu	puM																						
keSiniRUxana	puM	keSiniRUxanudu^viRNuvu	puM																						
kevala	napuM:puM	kevalaM	napuM:napuM																						
kilbiRa	napuM	wappu^pApamu^ceVdu_viRayaM	napuM																						
kirItin	puM	arjunudu^kirItamu_XariMcuvAdu	puM																						
kIrwi	puM:swrI	kIrwi	napuM:napuM																						
klEbya	napuM	pirikiwanamu^klEbyaM	napuM																						
kleSa	napuM:puM	kleSaM^kaRtaM^vexana^xuHKaM	napuM:napuM																						
kleSa	napuM:puM	xuHKaM^kaRtaM^bAXa	napuM:napuM																						
kOmAra	napuM:puM	kumArAvasWa	napuM:napuM																						
kOnweya	puM	kuMwI_puwrudu	puM																						
kOSala	napuM	kuSalawa^prasannawa	napuM																						
kqpA	swrI	kqpa^xaya^kanikaraM	napuM																						
kqpa	puM	kqpa^xaya^kanikaraM	puM																						
kqpaNa	napuM:puM:swrI	kqpaNudu^loBi^kuwsiwudu	puM																						
kqRi	swrI	kqRi^sexyamu^Srama^vyavasAyamu	napuM																						
kqRNa	napuM:puM:swrI:vi	kqRNudu^nalupu^xrOpaxi^kqRNA_naxi	puM:swrI:napuM:vi																						
kqwa	puM:napuM	kqwa^ceyabadinaxi	napuM:napuM																						
kqwsna	napuM:puM	aMwayu^jalamu	napuM:napuM																						
kqwya	napuM:puM	ceRta^kAryamu^ceyadaM^pani	napuM:napuM																						
kRamA	swrI	kRama^pqWvI^sahanaM	napuM																						
kRamin	puM	sahanaSIludu^kRamiMcuvAdu	puM																						
kRaNa	napuM:puM	kRaNaM	napuM:napuM																						
kRAnwi	swrI	gawi^gamanaM	napuM																						
kRara	puM:napuM	BUmi^meGamu	napuM:napuM																						
kRAwra	napuM	kRawriya_jAwi	napuM																						
kRawriya	puM	kRawriyudu	puM																						
krawu	puM	yajFamu^ceyabadunaxi	napuM																						
kRaya	napuM:puM	kRaya^nASamu	napuM:napuM																						
kRema	napuM:puM	kRemaM	napuM:napuM																						
kRewra	napuM	Bumi^kRewramu^sWalamu^paMta_BUmi	napuM:napuM																						
kRewrin	puM	BUsvAmi^Barya_kalavAdu	puM																						
kRipram	puM:napuM	SIGraM^vegaM	napuM:napuM																						
kriyA	swrI	ceRta^pani^kriya	napuM																						
kroXa	napuM:puM	kroXamu	napuM:napuM																						
krUra	napuM:puM	krUra^nirxaya^hiMsiMcadaM	napuM:napuM																						
kRuxra	puM	sUkRmaM	napuM																						
kula	napuM	kulaM	napuM																						
kulaGna	napuM:puM	kulamunu_nASamu_ceyuvAdu	puM:puM																						
kunwiBoja	puM	kunwiBojudu	puM																						
kunwI	swrI	kunwi	swrI																						
kUrma	puM	wAbelu^viRNu_avawAraM	napuM																						
kuru	puM	kuru_xeSaM	napuM																						
kurunanxana	puM	kurunaMxanudu	puM																						
kurusawwama	puM	kurusawwamudu^kuruSreRtudu	puM																						
kuSa	puM	kuSa^xarBamu	napuM																						
kuSala	napuM:puM	kuSalaM	napuM:napuM																						
kusumAkara	puM	uxyAnaM^vasaMwa_qwu	napuM																						
kUtasWa	napuM:puM	parabrahma^Awma^kAlamuwo_mAranixi	napuM:napuM																						
lABa	puM	lABaM	napuM																						
lAGava	napuM:puM	lAGavaM^culakana	napuM:napuM																						
laGvASin	puM	koMceM^nIca^koMceM_winuvAdu	napuM																						
lakRaNa	napuM	lakRaNaM	napuM																						
lavaNa	napuM:puM	lavaNamu^uppu	napuM:napuM																						
lifga	napuM	lifgaM	napuM																						
loBa	napuM:puM	loBaM^ASa	napuM:napuM																						
loka	napuM:puM	lokaM	napuM:napuM																						
loRta	puM:napuM	matti_gadda	napuM:napuM																						
mahAbAhu	napuM:puM	mahAbAhu^balamEna_Bujamulu_kalavAdu	puM:puM																						
raWa	puM	raWaM	napuM																						
SafKa	puM:napuM	SaMKaM	napuM:puM																						
mahAnuBAva	napuM:puM	mahAnuBAvudu	puM:puM																						
mahAraWa	puM	mahAraWudu	puM:puM																						
mahaw	napuM:puM	mahawwu^goppaxi	napuM:napuM																						
aSana	napuM	vyApwi^goppa_Akali	napuM																						
mahawI	swrI	goVppaxi^nAraxuni_vINa	napuM																						
mahAwman	napuM:puM	mahAwmudu	puM:puM																						
mAhAwmya	napuM	mAhAwmyaM^goppaxanaM	napuM																						
maheSvara	puM	maheSvarudu	puM																						
mahI	swrI	BUmi^mahi	napuM																						
mahIkRiw	puM	rAju^praBuvu	puM																						
mahiman	puM	goppawanamu^Esvaryamu	napuM																						
makara	puM	makaramu^moVsali	napuM																						
mala	puM	malamu	napuM																						
mAmaka	puM	mA_vAdu^mAxi	puM																						
mAmikA	swrI	mA^mAxi	swrI																						
mAna	puM	mAna^aBimAnamu^AxaraNa^ahaMkAraM^prawiRtA	napuM																						
mAna	puM	mAnamu	napuM																						
manas	napuM	manassu	napuM																						
mAnasa	puM	manassu^mAnasa_sarovaramu	napuM																						
mAnasa	puM	manassu	napuM																						
mAnava	puM	mAnavudu^maniRi^manu_saMbaMXa	puM																						
maNi	puM	ABURaNaM^rawnamu	napuM																						
maNipuRpaka	puM	maNipuRpakamu^sahaxevuni^SafKamu	napuM																						
manIRin	puM	buxXimaMwudu^vixvAMsudu	puM																						
manoraWa	puM	manoraWaM	napuM																						
manu	puM	manu^buxXi	napuM																						
mAnuRa	puM	maniRi^manavudu^puruRudu	puM																						
mAnuRI	swrI	Ada_maniRi	swrI																						
manuRya	puM	maniRi^manuRya_jAwi	napuM																						
manwra	puM	maMwraM	napuM																						
manxa	napuM:puM	maMxa^paSu_samUhamu	napuM:napuM																						
maraNa	napuM	maraNaM	napuM																						
mArgaSIrRa	puM	mArgaSira_mAsaM	napuM																						
marIci	puM	sUryudu^kiraNamu	napuM																						
maruw	puM	vAyuvu^gAli	napuM																						
mAruwa	napuM:puM	vAyuvu^gAli	napuM:napuM																						
marwya	puM	naSiMcunaxi^BUlokaM^mAnavudu	napuM																						
mArxava	napuM	mqxuwvaM^sukumArawa^meVwwana	napuM																						
mAsa	puM	mAsamu	napuM																						
mAsa	puM	mAsaM^neVla	napuM																						
mawa	napuM:puM	mawaM^aBiprAyaM^sammawaM	napuM:napuM																						
mawi	swrI	mawi^buxXi^icCa	napuM																						
mAwq	swrI	walli^lakRmi	swrI																						
mAwrA	swrI	parimANaM^koMceM	napuM																						
mAwra	napuM:puM	mAwrame	napuM:napuM																						
mAwula	puM	menamAma	puM																						
maxa	napuM:puM	maxamu^mawwu	napuM:napuM																						
mAXava	puM	mAXavudu	puM																						
maXusUxana	puM	maXusUxanudu	puM																						
maXya	napuM:puM	maXyamu	napuM:napuM																						
maXyasWa	napuM:puM	maXyavarwi	puM:puM																						
mAyA	swrI	mAya	napuM																						
meru	puM	meru_parvawaM	napuM																						
mEwra	puM	mEwri^miwrudu^sneha_BAvaM	napuM																						
meXA	swrI	meXassu^XAraNA_Sakwi^buxXi	napuM																						
meXas	puM	meXassu	napuM																						
meXAvin	puM	meXAvi	puM																						
miSra	puM	miSraM	napuM																						
miwra	napuM:puM	sUryudu^miwrudu	napuM:napuM																						
moGa	napuM	vyarWaM^nirarWakaM	napuM																						
moha	puM	mohaM	napuM																						
moha	puM	mohamu	napuM																						
mohana	puM:napuM	mohiMpa_ceyuvAdu	puM:puM																						
mohinI	swrI	mohinI	swrI																						
mokRa	puM	mokRamu	napuM																						
mOna	napuM	mOnaM	napuM																						
mOnin	puM	mOnaM^mOnavrawaM_AcariMcevAdu	napuM																						
mqga	puM	mqgaM	napuM																						
mqgenxra	puM	mqgenxrudu	puM																						
mqwyu	puM	mqwyuvu	napuM																						
mqwyu	puM	yamudu	puM																						
muKa	napuM	muKaM	napuM																						
muKya	napuM:puM	muKyaM	napuM:napuM																						
muKya	napuM:puM	muKyudu	puM:puM																						
mUla	napuM	mUlamu	napuM																						
mUla	napuM	mUlamu^moVxalu	napuM																						
mUla	napuM	mUlamu^moVxalu^kAraNamu	napuM																						
mumukRu	puM	mokRaM_korevAdu	puM																						
muni	puM	muni	puM																						
mUrwi	puM:swrI	mUrwi^prawima^SarIraM	napuM:napuM																						
mUrXan	puM	mUrXamu^sirassu^wala	napuM																						
Axi	napuM	praWamaM	napuM																						
naBas	napuM	AkASaM	napuM																						
nacirAw	puM:napuM	naciraM^kRaNikaM	napuM:napuM																						
nAga	napuM:puM	nAga^pAmu^enugu	napuM:napuM																						
nakRawra	napuM	nakRawraM	napuM																						
nakula	puM	nakuludu^kulaM_lenivAdu	puM																						
nakula	puM	muMgisa	napuM																						
namas	puM:napuM	namaskAraM^xaMdamu	napuM:napuM																						
nAman	napuM	peru	napuM																						
namasya	puM:napuM	pUjanIya^arcanIya^saparya	napuM:napuM																						
nara	puM	narudu	puM																						
naraka	napuM:puM	narakaM	napuM																						
nAraxa	puM	nAraxudu	puM																						
narAXama	puM	narAXamudu	puM																						
narAXipa	puM	narAXipawi	puM																						
nArI	swrI	nAri	swrI																						
nASa	puM	nASamu^naSiMcu	napuM																						
nAsA	swrI	mukku	napuM																						
nASana	puM:napuM	nASanamu	napuM:napuM																						
nava	napuM:puM	nava^wommixi	napuM:napuM																						
navan	napuM	nava^wommixi	napuM																						
naxI	swrI	naxi	napuM																						
nAyaka	puM	nAyakudu	puM																						
nayana	napuM	nayanamu^kannu	napuM																						
nERkarmya	napuM	kriya_hInawa^niRkAma_karmalu_ceyuta	napuM																						
nERTikI	swrI	niRTa_kalavAdu	puM																						
newra	napuM	newramu^kannu	napuM																						
nibanXa	puM	nibanXanaM	napuM																						
nigraha	puM	nigrahaM	napuM																						
niHspqha	puM	niHspqha^spqha_lekuMduta	napuM																						
niHSreyasa  Sreyas?	puM:napuM	niHSreyassu^Sreyassu_kAnixi	napuM:napuM																						
nimiwwa	napuM	nimiwwaM^kAraNaM	napuM																						
ninxA	swrI	niMxa	napuM																						
nirahafkAra	puM:napuM	nirahafkAri	napuM:napuM																						
nirAhAra	puM:napuM	nirAhAra^AhAraM_lekapovadaM	napuM:napuM																						
nirASis	puM	ASa_lekapovadaM	napuM																						
nirASraya	puM:napuM	nirASrayaM^ASrayaM_lekapovuta	napuM:napuM																						
nirawa	napuM:puM	nirawamu	napuM:napuM																						
nirguNa	napuM	nirguNa^mUrKudu^paramAwma	napuM																						
nirmala	napuM:puM	nirmalaM^svacCaM^SuxXaM	napuM:napuM																						
nirmama	napuM:puM	mamakAraM_lekapovadaM	napuM:napuM																						
nirmAna	napuM	aBimAnaM_lekapovadaM	napuM																						
niRTA	swrI	niRTa	napuM																						
nirvANa	puM:napuM	nirvANamu^mukwi^mokRamu	napuM:napuM																						
nirvEra	puM:napuM	vEraM_lenixi	napuM:napuM																						
nirvexa	puM	nirvexaM^nirASa^vErAgyaM	napuM:napuM																						
nirvikAra	puM:napuM	nirvikArudu^vikAramu_lenivAdu	puM:puM																						
nirxeSa	puM	nirxeSaM^AjFa	napuM																						
nirxoRa	puM:napuM	nirxoRaM^nirxoRi^xoRaM_lekuMduta	napuM:napuM																						
nirxvanxva	napuM	rAgaxveRamulu_lenivAdu	puM																						
niSA	swrI	rAwri^pasupu	napuM																						
niScalA	swrI	niScalaM	napuM																						
niScaya	puM	niScayamu^nirNayamu	napuM																						
niswrEguNya	napuM	anAsakwudu^wriguNamulu_lenivAdu	puM																						
nivAsa	napuM:puM	nivAsaM	napuM:napuM																						
nivqwwi	swrI	nivqwwi^viramiMcuta^nivAraNamu	napuM																						
nIwi	swrI	nIwi	napuM																						
niwya	napuM:puM	niwyaM	napuM:napuM																						
vErin	napuM	vEri^viroXi	puM																						
niXana	napuM	niXi^ASrayamu	napuM																						
niXAna	napuM	uMcuta^saMpaxa^niXi	napuM																						
niXana	napuM	niXanudu^xarixrudu^bIxavAdu	puM																						
nixrA	swrI	nixra	napuM																						
niyama	puM	niyamaM^prawijFa^nigrahaM	napuM																						
niyawa	napuM:puM	niSciwa^sWira	napuM:napuM																						
niyawa	napuM:puM	niwyaM^niSciwaM	napuM:napuM																						
nO	swrI	nAva^oda	napuM																						
nq	puM	maniRi	puM																						
nyAsa	napuM:puM	sWApiMcadaM^xAcataM	napuM:napuM																						
nyAyya	puM	nyAyaM^uciwaM^sAmAnyaM	napuM																						
ofkAra	puM	oMkAraM	napuM																						
ojas	napuM	Sakwi^balaM^prakASaM	napuM																						
Opamya	napuM	samarUpamu	napuM																						
ORaXa	napuM:puM	ORaXamu	napuM:napuM																						
oRaXI	swrI	ORaXaM	napuM																						
pAFcajanya	puM	pAFcajanyaM	napuM																						
paFcama	napuM:puM	paFcamaM^Exava	napuM:napuM																						
paFcan	napuM	paFca^Exu	napuM																						
pakRa	napuM:puM	prakka^paxihenu_rojulu	napuM:napuM																						
pakRin	puM	pakRi^rekkalu_galaxi	napuM																						
Pala	napuM	Palamu	napuM																						
pAla	puM:puM	pAlana^pAlakudu	napuM:puM																						
Pala	napuM	PalaM	napuM																						
palAyana	napuM	pAripovadaM	napuM																						
paNava	puM	oVka_vAyixyamu	napuM																						
Anaka	puM:napuM	vAyixyamu	napuM:napuM																						
pANdava	puM:napuM	pANdavudu	puM:puM																						
paNdiwa	puM	paMdiwudu^vixvAMsudu	puM																						
pANdu	puM	pANdu_rAju	puM																						
pANi	puM	ceyi^haswamu	napuM																						
pApa	napuM:puM	pApaM	napuM:napuM																						
pApman	puM	pApaM^aparAXaM^xuRta	napuM																						
para	napuM	paramu^anyamu^iwara	napuM																						
parA	swrI	SreRTamEnaxi	napuM																						
parama	napuM:puM	parama^muKya^aXika^SreRTaM	napuM:napuM																						
paramA	swrI	muKya^SreRTaM^praXAnaM	napuM																						
paramAwman	puM	paramAwma	puM																						
parameSvara	napuM:puM	parameSvarudu	puM:puM																						
paranwapa	puM	SawrunASakudu	puM																						
parasparam	puM:napuM	parasparaM	napuM:napuM																						
parawara	napuM:puM	waruvAwa^pimmata	napuM:napuM																						
parAyaNa	puM:napuM	parAyaNudu^AsakwikalavAdu^Asriwudu^aBIRtamu^Asakwi	puM:puM																						
parigraha	puM	svIkariMcadaM^cuttumuttadaM	napuM																						
parihArya	aBIRtamu^Asakwi	parihariMpawaginaxi^viduvawaginaxi	puM																						
parijFAwq	puM:napuM	jFAni^buxXimAn	napuM:napuM																						
parimeyA	swrI	koVluvaxaginaxi^parimiwa	napuM																						
pariNAma	napuM	pariNAmaM^mArpu^parivarwanaM	napuM																						
paripanWin	puM	Sawruvu^ahiwudu	puM																						
paripraSna	puM	praSna^kuSala_praSna	napuM																						
pariwrANa	napuM	saMrakRaNa	napuM																						
pariwyAga	puM	pariwyAgaM^wyAgamu_ceyadaM	napuM																						
pariwyAgin	puM:napuM	pariwyajiMcinavAdu^wyAgi	puM:puM																						
parjanya	puM	uwpAxanaM^kaligiMcadaM	napuM																						
parNa	napuM	parNaM	napuM																						
pAruRya	napuM	nirxaya^kaToraM^paruRaM	napuM																						
pArWa	puM	pArWudu^kuMwI_puwrudu	puM																						
paryanwa	napuM:puM	paryaMwaM^varaku	napuM:napuM																						
paryuRiwa	puM	pAcipoyinaxi^bahukAlaM_uMcabadinaxi	napuM																						
pAvaka	napuM:puM	agni^sUryudu	napuM:napuM																						
pAvana	puM:napuM	pAvanaM^paviwraM^paviwraM_ceyuta	napuM:napuM																						
pavana	napuM:puM	vAyuvu^gAli^pavanaM	napuM:napuM																						
paviwra	puM	paviwraM	napuM																						
pawafga	puM	pakRi^sUryudu^pawafgaM	napuM																						
pawi	puM	pawi^Barwa	puM																						
paWin	puM	mArgaM^xAri^wrova	napuM																						
pAwra	napuM:puM	pAwra^vixyA_guNamu_kalavAdu	napuM:puM																						
pawra	napuM	pawraM^Aku^xaswAveju	napuM																						
pAxa	puM	pAxamu	napuM																						
paxa	napuM	paxamu^BAgamu	napuM																						
paxa	napuM	adugu^sWAnaM^paxamu	napuM																						
pAxa	puM	pAxamu	napuM																						
paxma	puM:napuM	paxmaM^wAmara	napuM:napuM																						
pIdA	swrI	pIda^kaRtaM^vexana^karuNa	napuM																						
piNda	puM:napuM	piNdaM	napuM:napuM																						
piwAmaha	puM	piwAmahudu^wAwa	puM																						
piwq	puM	piwq^waMdri	puM																						
plavana	napuM	wariMcuta^Ixuta	napuM																						
pONdra	puM	pONdra_xeSaM	napuM																						
pOruRa	napuM:puM	pOruRaM^parAkramaM^puruRa_BAvaM	napuM:napuM																						
pOrvaxehika	napuM	pUrvajanma_pApapuNyamulu	napuM																						
pOwra	puM	pOwrudu^manumadu^kodudu_koduku	puM																						
pqRTa	napuM	veVnuka	napuM																						
pqWakwva	napuM	veru	napuM																						
pqWivI	swrI	pqWivi^BUmi	napuM																						
pqWivIpawi	puM	rAju	puM																						
praBA	swrI	praBa^veVlugu^wejassu	napuM																						
praBAva	puM	praBAvamu^kAMwi^sAmarWyamu	napuM																						
praBava	puM	praBAvaM	napuM																						
praBaviRNu	napuM:puM	SakwiSAli^sAmarWyaM_kalavAdu	puM:puM																						
praBu	napuM:puM	praBuvu^rAju^aXipawi^svAmi	puM:puM																						
prAFjali	puM	aFjali	napuM																						
praharaNa	napuM	kottuta^AyuXaM	puM																						
prahlAxa	puM	prahlAxudu	puM																						
prajA	swrI	prajalu	puM																						
prajana	puM	uwpAxanaM^cUlu^garBamu	napuM																						
prajApawi	puM	prajApawi^rAju	puM																						
prajFA	swrI	prajFa^buxXi	napuM																						
prAjFa	puM:swrI	buxXi	napuM:napuM																						
prakASa	napuM:puM	prakASaM	napuM:napuM																						
prakASaka	puM:napuM	prakASakudu^veVlugu_iccuvAdu	puM:puM																						
prakIrwi	swrI	kIrwi^prasixXi^yaSassu	napuM																						
prAkqwa	puM:napuM	sAmAnya^sAXAraNa^prAkqwa_BARa	napuM:napuM																						
prakqwi	swrI	prakqwi^jIvamu^svaBAvamu	napuM																						
sWa	puM:napuM	uMdu	napuM:napuM																						
pralaya	puM	pralYayaM	napuM																						
pralIna	puM	naRtamEnaxi^cewanamu_lenixi	napuM																						
pramAWin	napuM	pIdiMcuvAdu	puM																						
pramAxa	puM	pramAxaM^xurGatana	napuM																						
pramuKa	napuM	pramuKaM^muKyaM^SreRTaM	napuM																						
prANa	puM	prANamu^jIvamu^prANa_vAyuvu	napuM																						
praNava	puM	praNavAkAraM^oMkAraM	puM																						
praNaya	puM	praNayaM^vivAhaM^snehaM^prema	napuM																						
prANin	napuM:puM	prANi	napuM:napuM																						
praNipAwa	puM	praNAmaM^namaskAraM^aBivAxanaM	napuM																						
prapiwAmaha	puM	muwwAwa	puM																						
prApwi	swrI	prApwi^poMxu^laBiMcu	napuM																						
prasaBa	napuM	balAwkAraM^hiMsa	napuM																						
prasafga	puM	prasafgaM^saMxarBaM	napuM																						
prasAxa	puM	prsAxamu^prasannamu^anugrahamu^nEvexyaM	napuM																						
pravAla	puM:napuM	ciguru^pagadamu	napuM:napuM																						
pravIra	puM:napuM	uwkqRta_yoXudu^pUjyudu	puM:puM																						
pravqwwi	swrI	AraMBaM^svaBAvaM	napuM																						
prawApa	puM	prawApaM^wejassu^vedi	napuM																						
prawIkAra	puM	prawIkAraM^viroXaM	napuM																						
prawyakRa	napuM:puM	prawyakRaM^kanipiMcunaxi^kalYlYa_eVxuru	napuM:napuM																						
prawyanIka	puM:napuM	Sawruvu^viroXi	puM:puM																						
prawyavAya	puM	avaroXaM^pApaM^kRINiMcuta	napuM																						
praxa	puM	xAwa	puM																						
prAXAnya	napuM	prAXAnyaM^muKyaM	napuM																						
prayANa	napuM	prayANaM	napuM																						
prayAwa	puM	canipovadaM^velYlYipovadaM^AkramiMcadaM	napuM																						
prayawna	puM	prayawnaM	napuM																						
prepsu	napuM	poVMxavalenani_korika_kalavAdu	puM																						
prIwi	swrI	prIwi	napuM																						
priyA	swrI	priya^priyurAlu	swrI																						
priya	napuM:puM	priyudu	puM:puM																						
pufgava	puM	puMgavudu^SreRtudu	puM																						
pUjana	napuM	pUjiMcadaM^gOraviMcadaM	napuM																						
pUjya	puM:swrI	pUjiMpaxaginaxi	napuM:napuM																						
punarAvarwin	puM	malYli_janmiMcuvAdu	puM																						
punarjanman	napuM	xvijanma^punarjanma^malYlYi_puttuta	napuM																						
puNya	napuM	puNyaM	napuM																						
pura	napuM	puramu^nagaramu	napuM																						
purANa	puM:napuM	purANaM^purAwana^prAcIna	napuM:napuM																						
purANI	swrI	puramulu^nagaramulu	napuM																						
purAwana	puM:napuM	purAwanaM	napuM:napuM																						
puRkalA	swrI	puRkalaM^aXikaM^SreRTaM^saMqxXaM	napuM																						
pUrNa	napuM:puM	pUrNamu^saMpUrNamu	napuM:napuM																						
puroXas	puM	purohiwudu	puM																						
puRpa	napuM	puRpaM^pUvu^kusumaM	napuM																						
puRpiwA	swrI	pUcinaxi^wIga^vqkRaM	napuM																						
purujiw	puM	purujiwwudu	puM																						
pUruRa	puM	puruRudu^maniRi^Awma	puM																						
puruRa	puM	puruRudu	puM																						
puruRarRaBa	puM	SreRTa_puruRudu	puM																						
puruRowwama	puM	puruRowwamudu	puM																						
pUrva	napuM:puM	wUrpu^pUrvaM	napuM:napuM																						
pUrvaka	puM:napuM	pUrvakaM	napuM:napuM																						
pUwi	napuM	xurgaMXaM	napuM																						
puwra	puM	puwrudu	puM																						
qk	swrI	swuwi^praSaMsa^pUja^qigvexa	napuM																						
qRi	puM	qRi	puM																						
qwa	puM:napuM	pUjiMpabadunaxi^sawyamu	napuM:napuM																						
qwu	puM	qwuvu	napuM																						
rAga	puM	rAga^xuRta^mAwsaryamu^anurAgaM	napuM																						
rAgAwmaka	napuM	rAgAwmakaM^anurAgaM_kaliginaxi	puM																						
rAgin	puM	anurakwudu^rAgamu_kalavAdu	puM																						
rahas	napuM	ekAMwamu	napuM																						
rahasya	napuM:puM	rahasyaM	napuM:napuM																						
rahiwa	napuM:puM	rahiwa^viduvabadinaxi	napuM																						
rAjan	puM	rAju	puM																						
rajas	napuM:puM	rajoguNamu	napuM:napuM																						
rAjasa	napuM:puM	rajoguNa_saMbaMXiwa^rAju_saMbaMXiwa^wejassu	napuM:napuM																						
rAjasI	swrI	rajoguNa_saMbaMXiwa	napuM																						
rAjya	napuM	rAjyaM	napuM																						
rakRas	napuM	rAkRasudu	puM																						
rAkRasI	swrI	rAkRasi	swrI																						
rakRya	puM:napuM	rakRiMpaxaginaxi	napuM:napuM																						
rAma	puM	priyaM^manoharaM^AnaMxapraxa	napuM																						
rAma	puM	SrI_rAmudu	puM																						
raNa	napuM:puM	raNaM^yuxXaM^saMgrAmaM^samaraM	napuM:napuM																						
RaR	napuM	Rat^Aru	napuM																						
RaRTa	napuM:puM	Aravaxi	napuM:napuM																						
rasa	puM	rasa	napuM																						
rasa	puM	sAraM	napuM																						
rasana	napuM	nAluka^ruci	napuM																						
rasAwmaka	napuM:puM	rasAwmakaM^sAravaMwaM	napuM:napuM																						
rASi	puM	samUhamu	napuM																						
rasya	napuM:puM	sAravaMwaM^rucikaraM	napuM:napuM																						
ravi	puM	sUryudu	napuM																						
raWa	puM	raWaM	napuM																						
rawi	swrI:swrI	anurAgaM^rawI_xevi	napuM:swrI																						
rawi	swrI	AnaMxaM^prema^Bakwi	napuM																						
rAwra	napuM:puM	rAwri	napuM																						
rAwri	swrI	rAwri	napuM																						
ripu	puM	Sawruvu	puM																						
roman	napuM	romamu^cinna_veVMtruka	napuM																						
rUkRa	puM	karuku^paruRaM	napuM																						
rUpa	napuM	rUpamu	napuM																						
ruxra	napuM:puM	ruxra^BayAnaka^Bayafkara	napuM:napuM																						
Sabxa	puM	Sabxamu	napuM																						
carAcara	puM:napuM	prapaMcaM	napuM:napuM																						
saFcaya	puM	samUhamu	napuM																						
safGa	puM	saMGamu^samUhamu^kaliyunaxi^kUduta^sahavAsaM	napuM																						
safGAwa	puM	samuxAyaM^samUhamu	puM																						
safgin	napuM:puM	snehaSIludu	puM:puM																						
safgraha	puM	safgrahaM^sekariMcu^safkRipwa	napuM																						
safgrAma	puM	safgrAmaM^yuxXaM^kalahaM^poru	napuM																						
saFjaya	puM	saFjayudu	puM																						
saFjFaka	napuM:puM	peru	napuM:napuM																						
saFjFiwa	napuM:puM	perugalaxi	napuM:napuM																						
SafKa	puM	SafKamu	napuM																						
safkalpa	puM	safkalpamu^icCASakwi^mAnasika_xqDawvaM	napuM																						
Safkara	puM	Safkarudu	puM																						
safkara	puM	safkara_jAwi^kUdika	napuM																						
sAfKya	napuM:puM	safKyA_saMbaMxiwa^sAfKya_xarSanaM	napuM:napuM																						
safKya	napuM	safKya^aMkeV	napuM																						
safKyAna	napuM	safKya	napuM																						
sAgara	puM	sAgaraM	napuM																						
sAgara	puM	sAgaraM^samuxraM	napuM																						
saha	puM:napuM	orpu_unnavAdu^sahiwamu^Sakwi^sAmarWyaM	puM:napuM																						
sahaja	puM	sahajaM	napuM																						
sahasra	napuM	sahasraM^veyi	napuM																						
sahaxeva	napuM:puM	sahadevudu	puM:puM																						
SAKA	swrI	SAKa^cettu_komma^Bujamu	napuM																						
saKa	puM	miwrudu^sakudu	puM																						
saKi	puM	saKi^celiya	swrI																						
sAkRin	puM	sAkRi^cUcinavAdu	puM																						
sakwa	puM:napuM	Asakwudu	puM:puM																						
sama	napuM:puM	samAnamu^samaswaM^samaM	napuM:napuM																						
Sama	napuM:puM	SAMwi^upaSamanaM	napuM:napuM																						
samagra	napuM:puM	samaswaM^samagraM	napuM:napuM																						
samakRa	napuM:puM	samakRaM	napuM:napuM																						
samam	puM:napuM	samaM^samAnaM	napuM:napuM																						
sAman	napuM	mqxuwvaM^sAmavexaM	napuM																						
samanwAw	puM:napuM	aMwatA^viSva_vyApi	napuM:napuM																						
samanwa	puM:napuM	aMwata	napuM:napuM																						
samAramBa	puM	AramBaM	napuM																						
sAmarWya	napuM	sAmarWyaM	napuM																						
samAsa	puM	samAsaM	napuM																						
sAmAsika	napuM:puM	samAsa_saMbaMXa^sAmUhika	napuM:napuM																						
sAmavexa	puM	sAmavexaM	napuM																						
samawA	swrI	samawvaM^samawA	napuM																						
samaxarSin	napuM:puM	samaxqRti_kalavAdu^wawva_jFAni	puM:puM																						
samAXi	puM	samAXi^manolayamu	napuM																						
samAXi	puM	samAXi^ekAgrawa^wapassu	napuM																						
sambanXin	puM	saMbaMXaM_kalavAdu	puM																						
samBava	puM	saMBavaM^uxBavaM^puttuka	napuM																						
samiwiFjaya	napuM:puM	yuxXamaMxu_vijayudu	puM:puM																						
sammoha	puM	ajFAnaM^mUrKawvaM^prema^AkarRaNa	napuM																						
sammuKa	napuM:puM	aBimuKaM^eVxuru	napuM:napuM																						
sampAwa	puM	pawanaM	napuM																						
sampax	swrI	saMpaxa	napuM																						
uxaka	napuM	nIru^jalaM	napuM																						
samprawiRTA	swrI	saMprawiRTa^unnawa_sWiwi	napuM																						
saMsAra	puM	saMsAraM^mArgaM^lOkika_jIviwaM	napuM																						
saMsax	swrI	saBa	napuM																						
saMSaya	puM	saMSayaM^saMxehaM	napuM																						
saMsixXi	swrI	pUrNamu^svaBAvamu	napuM																						
saMsparSa	puM	cakkani_sparSa	napuM																						
saMSuxXi	swrI	SuxXi^svacCaM	napuM																						
saMsWa	napuM:puM	saMsWa^vyavasWa	napuM:napuM																						
saMsWA	swrI	saMsWa	napuM																						
saMsWApanA	swrI	saMsWApanamu^sWApanamu	napuM																						
saMswuwi	swrI	swuwi	napuM																						
samuxBava	puM	uxBaviMcuta^puttuta	napuM																						
samuxra	napuM:puM	samuxraM^kadali^sAgaraM	napuM:napuM																						
samuxXarwq	puM	mukwi_xAwa	puM																						
samuxyama	puM	pEki_leputa^samAraMBaM	napuM																						
saMvAxa	puM	saMvAxaM^carca	napuM																						
saMvigna	napuM:puM	uxvegaM_ceVMxinavAdu	puM:puM																						
sAmya	napuM	samAnaM^samawvaM	napuM																						
saMyama	puM	niyanwraNa^saMyamanamu^iMxriya_nigrahamu	napuM																						
saMyamin	puM	niyaMwriMcuvAdu	puM																						
saMyawa	napuM:puM	kattabadinaxi^baMXiMpabadinaxi	napuM:napuM																						
saMyoga	puM	saMyogaM^kalayika^saMgamaM	napuM																						
sanAwana	puM	sanAwanaM^prAcInaM^SaSvawaM	napuM																						
sanniBa	puM:napuM	samAnamu	napuM:napuM																						
sannyAsa	puM	sannyAsaM	napuM																						
sannyasana	napuM	sannyasiMcadaM^wyAgaM^vErAgyaM	napuM																						
sannyAsin	puM	sannyAsi	puM																						
SAnwa	napuM:puM	SAnwi_poVMxinavAdu	puM:puM																						
sanwa	puM	aMjali	napuM																						
sanwawa	napuM:puM	eVllappudu^niraMwaramu^niwyamu^aXikamu^viswIrNamEnaxi	napuM:napuM																						
SAnwi	swrI	SAMwi^Samanamu	napuM																						
sanxeha	puM	saMxehamu	napuM																						
sapawna	puM	Sawruvu	puM																						
sapawna	puM	Sawruvu^viroXi	puM																						
Sara	napuM:puM	SaraM^bANaM	napuM:napuM																						
SaraNa	napuM	SaraNamu	napuM																						
saras	napuM	sarassu	napuM																						
sarga	puM	sargamu^sqRti	napuM																						
sarga	puM	sarga	napuM																						
SArIra	napuM:puM	SarIra_saMbaMXa	napuM:napuM																						
SarIra	napuM:puM	SarIramu	napuM:napuM																						
SarIrin	puM:puM	SarIramu_kalaxi	puM:napuM																						
Sarman	napuM:puM	brAhmaNudu^saMwoRamu	puM:napuM																						
sarpa	puM	sarpamu^pAmu^gamanaM^anusaraNaM	napuM																						
SaSAfka	puM	SaSAfkudu^caMxrudu	napuM																						
SaSin	puM	SaSi^caMxrudu	napuM																						
SaSvaw	swrI	marala^niraMwaramu	napuM																						
SASvawa	napuM	SASvawamu^niwyamu	napuM																						
SASvawa	napuM	SASvawaM	napuM																						
SASvawI	swrI	SASvawamEnaxi^niwyamEnaxi	napuM																						
SAswra	napuM	Saswramu	napuM																						
Saswra	napuM	Saswramu^AyuXamu	napuM																						
SaTa	napuM:puM	kuwsiwudu^mUrKudu	puM:puM																						
savyasAcin	puM	arjunudu	puM																						
saw	napuM:puM	yaWArWaM^pAvanaM^maMci	napuM:napuM																						
Sawa	napuM	nUru^vaMxa^aneka_viXamuluga	napuM																						
sawawa	puM:napuM	eVllappudu^niraMwaraM	napuM:napuM																						
sawkAra	puM	sawkAraM	napuM																						
Sawru	puM	Sawruvu	puM																						
sawwva	napuM	sawva_guNaM^sawwaM^balaM^Sakwi	napuM																						
sAwwvika	puM	sawva_guNaM_kalavAdu	puM																						
sAwwvikI	swrI	sawva_guNaM_kalaxi	napuM																						
sawya	napuM:puM	sawyaM	napuM:napuM																						
sAwyaki	puM	sAwyaki	napuM																						
sax	puM:napuM	uwwamamEna^sawyaM	napuM:napuM																						
sAxana	napuM	aByAsaM	napuM																						
sAXarmya	napuM	samAnawa	napuM																						
saxqSa	puM	samAnamu	napuM																						
saxqSI	swrI	samAnamu	napuM																						
sAXu	napuM:puM	uwwamaM^SreRTaM	napuM:napuM																						
sAXya	puM	sAXyaM^ceyaxaginaxi	napuM																						
SayyA	swrI	padaka^maMcamu	napuM																						
SEbya	napuM:puM	SEbyudu	napuM:puM																						
senA	swrI	sena^sEnyamu	napuM																						
senAnin	puM	nAyakudu	puM																						
sEnya	puM	sEnyaM	napuM																						
sevA	swrI	seva	napuM																						
sevin	puM	seviMcuvAdu	puM																						
SiKaNdin	napuM:puM	SiKaMdi^neVmali	napuM:napuM																						
SiKarin	puM	SiKaramu_kalaxi^parvawamu	napuM																						
Sila	napuM:puM	Sila^svaBAvamu	napuM:napuM																						
siMhanAxa	puM	siMhanAxaM	napuM																						
Siras	napuM	Sirassu	napuM																						
SiRya	puM	SiRyudu	puM																						
Siwa	napuM:puM	Siwamu	napuM:napuM																						
sixXi	swrI	sixXi^saPalawvaM^saMpUrNaM^neVraveruta	napuM																						
skanxa	puM	kumAra_svAmi	puM																						
smqwi	swrI	smaraNa	napuM																						
sOBaxra	puM	sOBaxrudu^suBaxruni_koduku	puM																						
SOca	napuM	SOcamu^pariSuBrawa	napuM																						
Socya	puM:napuM	xuHKimpawagina^SocanIyamu	napuM:napuM																						
Soka	puM	Sokamu	napuM																						
sOkRmya	napuM	sUkRmamu	napuM																						
soma	puM	soma_yAga^amqwaM	napuM																						
somapA	swrI	somapAnaM_ceyuvAdu	puM																						
sOmaxawwi	puM	sOmaxawwudu	puM																						
sOmya	napuM:puM	sOmya^mqxuwvaM^suMxaraM^SuBaM	napuM:napuM																						
sOmyawva	napuM	sOmyawa	napuM																						
SOrya	napuM	SOryamu	napuM																						
sparSa	puM	sparSa	napuM																						
sparSana	napuM	vAyuvu^sparSa	napuM																						
spqhA	swrI	uwsukawa^icCA	napuM																						
spqha	puM	korika	napuM																						
sqwi	swrI	mArgaM	napuM																						
SraxXA	swrI	SraxXa	napuM																						
SreRTa	napuM:puM	SreRTamu	napuM:napuM																						
Sreyas	napuM:puM	Sreyassu^SuBamu	napuM:napuM																						
SrI	swrI	SrI^Esvaryamu	napuM																						
SrImaw	napuM:puM	SoBanakaramEna	napuM:napuM																						
Srowra	napuM	ceVvi^karNamu	napuM																						
Sruwi	swrI	vexamu^ceVvi	napuM																						
SuBa	napuM:puM	SuBamu^maMgalYamu	napuM:napuM																						
Suci	puM:swrI	Suci^SuxXaM^svacCa	napuM:napuM																						
suGoRa	puM:napuM	GoRa	napuM																						
suhqx	puM:swrI:vi	snehiwudu	puM:swrI																						
suKa	napuM:puM	suKamu	napuM:napuM																						
suKin	napuM:puM	suKamu_kalavAdu	puM:puM																						
Sukla	napuM	SuxXaM^weVlupu	napuM																						
sukqw	puM	puNyAwmudu^XArmikudu	puM																						
sukqwa	napuM	puNyaM^SuBa_kAryaM	napuM																						
sukqwin	puM	paropakAri	puM																						
sUkRma	napuM	sUkRmaM	napuM																						
sulaBa	napuM:puM	sulaBaM^sulaBamugA_laBiMcunaxi	napuM:napuM																						
suniSciwa	napuM	buxXimaMwudu	puM																						
SUra	puM	SUrudu	puM																						
sura	puM	xevawa^sUryudu^jFAnavaMwudu	puM																						
sUrya	puM	sUryudu	napuM																						
SuSrURu	napuM:puM	vinavalenani_korika_kalavAdu	napuM																						
susuKa	napuM	sOKyamu_kalaxi	napuM																						
sUwra	napuM	sUwramu^xAramu^safkRipwa_viXi	napuM																						
SUxra	puM	SUxrudu	puM																						
suxuRkara	puM:napuM	xuRkaraM^kaRtasAXyaM	napuM:napuM																						
suxurlaBa	puM:napuM	xurlaBamu	napuM:napuM																						
suxurxarSa	puM:napuM	xuraxqRtamu	napuM:napuM																						
SuxXi	swrI	SuxXi	napuM																						
sva	napuM:puM	sva^wana	puM																						
bAnXava	puM	baMXuvu	puM																						
svaBAva	puM	svabAvaM	napuM																						
svaka	puM	wanaxi^wanavAdu	puM																						
svalpa	napuM:puM	svalpaM	napuM:napuM																						
Svan	puM	kukka	napuM																						
SvapAka	puM	caMdAludu	puM																						
svapna	puM	svapnamu	napuM																						
svapna	puM	svapnaM^kala	napuM																						
svarga	puM	svargaM	napuM																						
svargya	puM:napuM	svargaM_koVrakuceyu_SuBakAryamu	napuM:napuM																						
SvaSura	puM	mAmagAru	puM																						
svasWa	napuM:puM	ArogyavaMwudu	puM:puM																						
svaswi	napuM	kRemaM^SuBaM^maMgalYaM	napuM																						
svaXA	swrI	svaXA^Ahuwi	napuM																						
svaXarma	puM	svaXarmaM	napuM																						
svAXyAya	puM	svAXyAyamu^vexAXyayanamu	napuM																						
Svewa	napuM:puM	Svewamu^weVlupu	napuM:napuM																						
sWa	napuM:puM	sWiwi^sWiwi_Siludu	napuM:puM																						
sWAna	napuM	sWAnaM^sWiwi^nivAsaM	napuM																						
sWANu	napuM:vi	XqDa^sWira	napuM																						
sWAvara	napuM:puM	sWAvaraM^kaxalanixi	napuM:napuM																						
swena	puM	xoVMga	puM																						
sWErya	napuM	sWEryaM^XqDawvaM^sWirawvaM	napuM																						
sWirA	swrI	sWiraM	napuM																						
sWira	puM	sWiraM	napuM																						
sWiwa	napuM:puM	unnaxi^niScaludu	napuM:puM																						
sWiwi	swrI	parisWiwi^sWiwi	napuM																						
swrI	swrI	swrI	swrI																						
swuwi	swrI	swuwi	napuM																						
SyAla	puM	bAvamarixi	puM																						
syanxana	napuM	raWaM	napuM																						
uBa	puM:swrI	reVMdu	napuM:napuM																						
uBaya	napuM:puM	uBayamu^reVMdu	napuM:napuM																						
ucca	napuM:puM	unnawaM	napuM:napuM																						
uccEHSravasa	puM	poVdugu_ceVvulu_kalavAdu	puM																						
ucCoRaNa	napuM	eVMdipovadaM	napuM																						
ugrA	swrI	ugramu^BayaMkara	napuM																						
ugra	napuM:puM	ugramu^BayaMkara	napuM:napuM																						
ulba	napuM	garBASaya	napuM																						
upaBoga	puM	upaBogaM^suKaM	napuM																						
upakAra	puM	upakAraM^melu	napuM																						
upakArin	puM	upakAri^upakAraM_ceyuvAdu	puM																						
upama	puM:napuM	upAyamu^polika	napuM:napuM																						
upamA	swrI	polika	napuM																						
upapawwi	swrI	kAraNaM^xqRtAMwamu	napuM																						
upAsana	napuM	seva^ArAXana^upAsanamu	napuM																						
upasWa	napuM:puM	maXya_Bagamu	napuM:napuM																						
uraga	puM	sarpamu^pAmu	napuM																						
uRmapA	swrI	vedigA_wrAguvAru^piwq_gaNaM	puM:puM																						
uRNa	napuM:puM	uRNamu	napuM:napuM																						
uru	napuM	goppa^SreRtamEna^viswqwa	napuM																						
UrXvam	napuM	mIxa_unnaxi^pEki	napuM																						
uSanA	swrI	SukrAcAryudu	puM																						
uwsAha	puM	uwsAhamu	napuM																						
uwsanna	puM:napuM	naSiMcuvAdu	puM:puM																						
uwWa	napuM:puM	melukovataM^pEki_levatam	napuM:napuM																						
uwwamOjas	puM	prakASamu^wejassu	napuM																						
uwwara	napuM:puM	uwwaramu^uwwarapu_xikku	napuM:napuM																						
uwwarAyaNa	napuM	uwwrAyaNamu	napuM																						
uxakakriyA	swrI	jalawarpaNaM^uxakakriya	napuM																						
uxara	napuM	uxaramu^poVtta	napuM																						
uxAra	puM	uxAra^xAna_SIlawa	napuM																						
uxAsIna	napuM	uxAsInamu^Asakwi_lekapovuta^watasWaM^niRpakRapAwi	napuM																						
uxBava	puM	uwpawwi^OxAryaM^uxBaviMcunaxi	napuM																						
uxvega	puM	uxvegamu	napuM																						
uxxeSa	puM	uxxeSaM^BAvaM	napuM																						
vAc	swrI	vAkku	napuM																						
vacana	napuM	vacanaM	napuM																						
vacas	napuM	vacanaM	napuM																						
vAfmaya	napuM:puM	vAfmayaM^BARA	napuM:napuM																						
vahni	puM:swrI	agni	napuM:napuM																						
vajra	napuM:puM	vajrAyuXaM^vajraM	napuM:napuM																						
vAk	swrI	vAkku	napuM																						
vakwra	napuM:puM	muKamu	napuM:napuM																						
vAkya	napuM	vAkyaM	napuM																						
vANijya	napuM	vANijyaM^vyApAramu^varwakamu	napuM																						
vapus	napuM	SarIraM^xehaM	napuM																						
vara	napuM:puM	varaM^SreRtaM	napuM:napuM																						
varja	puM:napuM	vidupu^vaxuluta	napuM:napuM																						
varNa	napuM	varNamu^raMgu	napuM																						
varRa	puM	varRaM^saMvawsaraM	napuM																						
vArRNeya	puM	vArRNeyudu^SrIkqRNa	puM																						
varuNa	puM	varuNa_xevudu	puM																						
varwamAna	napuM:puM	varwamAnaM	napuM:napuM																						
varwman	napuM	mArgaM^wrova	napuM																						
vaSa	napuM:puM	vaSaM	napuM																						
vAsa	puM	nivAsaM	napuM																						
vAsas	napuM	vaswraM	napuM																						
vAsava	napuM:puM	iMxrudu	puM:puM																						
vaSin	napuM:puM	jiweMxriyudu	puM:puM																						
vasu	napuM:puM	vasuxevudu^gaNa_xevawa^XanaM^baMgAraM	puM:napuM																						
vAsuki	puM	vAsuki^nAga_rAju	napuM																						
vAsuxeva	puM	vAsudevudu^SrIkqRNudu	puM:puM																						
vaSya	napuM:puM	vaSamEnaxi	napuM:napuM																						
vAwa	puM	vAyuvu^vAwa_xoRaM^vAwa	napuM																						
vAxa	puM	vAxana^carcA^mAtalAduta	napuM																						
vaxana	napuM	vaxanaM	napuM																						
vAxin	puM	vakwa	puM																						
vAyu	puM	vAyuvu	napuM																						
vega	puM	vegaM^vadi^wvariwaM	napuM																						
vEnaweya	puM	vEnaweyudu	puM																						
vepaWu	puM	kaMpanaM	napuM																						
vErAgya	napuM	vErAgyaM^virakwi	napuM																						
vErin	puM	Sawruvu	puM																						
vESvAnara	puM	agni^vESvAnarudu	puM																						
vESya	puM	vESyudu	puM																						
vewwq	napuM:puM	welisinavAdu^pawi^qRi	puM:puM																						
vexa	puM	vexaM	napuM																						
vexAnwa	puM	vexAMwaM	napuM																						
viBAga	puM	viBAgamu	napuM																						
viBAvasu	puM	prakASaM^sUryudu	napuM																						
viBrama	puM	BrAMwi^AScaryamu	napuM																						
viBu	napuM	SakwivaMwudu	puM																						
viBUwi	swrI	viBUwi^Sakwi^Esvaryamu	napuM																						
vicakRaNa	puM	vicakRaNa	napuM																						
vicewas	puM	manovEkalyaM	napuM																						
vigawa	napuM:puM	lopiMcinaxi	napuM:napuM																						
viguNa	napuM:puM	guNa_hInudu	puM:puM																						
vihAra	puM	vihariMcuta^wota	napuM																						
vijaya	puM	vijayamu^geVlupu^vijayudu	napuM																						
vijFAna	napuM	vijFAnaM^jFAnaM	napuM																						
vikampa	napuM:puM	caMcala^asWiraM^vaNukuta	napuM:napuM																						
vikAra	napuM:puM	mArpu^vikAraM^rogaM^apahAsyaM	napuM:napuM																						
vikArin	napuM:puM	mArpu_ceMxunaxi	napuM:napuM																						
vikarman	napuM:puM	viruxXaMgA_AcariMcuvAdu	puM:puM																						
vikarNa	puM	vikarNudu	puM																						
vikrama	napuM:puM	SOryamu^parAkramamu	napuM:napuM																						
vimawsara	napuM	IrRya_lenivAdu	puM																						
vimokRa	puM	mukwi^mokRaM	napuM																						
vimokRaNa	puM:napuM	vaxilipettadaM	napuM:napuM																						
vinASa	puM	vinASanaM	napuM																						
vinaya	puM	vinayudu	puM																						
vinigraha	puM	nigrahamu^niyaMwaramu	napuM																						
viparIwa	napuM:puM	viruxXamu	napuM:napuM																						
vipaSciw	puM:napuM	paMdiwudu^vixvAMsudu	puM:puM																						
viprawipannA	pum:napuM	viroXamu	napuM:napuM																						
vIra	napuM:puM	vIrudu	puM																						
viRa	napuM	viRaM	napuM																						
virahiwa	napuM:puM	lenixi	napuM:napuM																						
viRama	napuM:puM	viruxXamu	napuM:napuM																						
virAta	puM	virAta_rAju	puM																						
viRAxa	puM	viRAxamu	napuM																						
viRAxin	napuM:puM	xuHKiMcuvAdu	puM:puM																						
viRaya	napuM:puM	viRayamu	napuM:napuM																						
viRNu	napuM:puM	viRNuvu	puM:puM																						
vIrya	napuM	vIrawvaM^parAkramamu^Sakwi^vIryamu	napuM																						
vIryavaw	napuM:puM	parAkramaM	napuM:napuM																						
viS	napuM:puM	vESyudu	puM:puM																						
viSAla	napuM:puM	viSAlaM	napuM:napuM																						
viSAraxa	napuM:puM	paMdiwudu^vixvAMsudu	puM:puM																						
visarga	puM	visarjanamu	napuM																						
viSeRa	napuM:puM	viSeRa^awyaMwa	napuM:napuM																						
vismaya	napuM:puM	vismayamu	napuM:napuM																						
viSuxXi	swrI	viSuxXi^SuxXi	napuM																						
viSva	napuM:puM	viSvaM	napuM:napuM																						
viSveSvara	puM	ViSveSvarudu^Sivudu	puM																						
viswAra	puM	viswAramu	napuM																						
viswara	napuM:puM	viswaraNaM	napuM:napuM																						
vivarXana	napuM	varXanamu	napuM																						
vivasvaw	napuM:puM	sUryudu	napuM:napuM																						
viviXA	swrI	viviXa	napuM																						
viviXa	napuM:puM	viviXa	napuM																						
viwweSa	puM	kuberudu	puM																						
vix	napuM	uMdadaM^AlociMcadaM	napuM																						
viXa	napuM:puM	viXamu	napuM:napuM																						
vixAhin	puM	kAlcuvAdu	puM																						
viXAna	napuM	viXAnamu	napuM																						
viXeya	napuM	vinayamu^viXeyaM	napuM																						
viXi	puM	viXi^niyamamu	napuM																						
vixiwa	napuM:puM	paMdiwudu	puM:puM																						
vixvas	puM	vixvAMsudu	puM																						
vixyA	swrI	vixya	napuM																						
viyoga	napuM:puM	viyogaM	napuM																						
vqjina	puM:napuM:vi	pApamu	napuM:napuM																						
vqkoxara	puM	vqkoxarudu^Bimudu	puM																						
vqkRa	puM	vqkRaM	napuM																						
vqRNi	puM	gollavAdu^kqRNudu	puM																						
vrawa	napuM:puM	vrawamu^niyamamu^AcaraNamu^prawijFA^nomu	napuM:napuM																						
vyaBicAra	puM	viruxXa_AcaraNaM^ullaMGanaM	napuM																						
vyaBicAriNI	swrI	vyaBicAriNi	swrI																						
vyAGra	puM	vyAGramu^puli	napuM																						
vyakwi	swrI	vyakwi	puM																						
vyAmiSra	napuM:puM	kalupabadu	napuM:napuM																						
vyapASraya	puM:napuM	ASrayiMcadaM	napuM:napuM																						
vyapewa	napuM:puM	vidipovadaM	napuM:napuM																						
vyAsa	puM	vyAsudu	puM																						
vyavasAya	puM	vyavasAyaM	napuM																						
vyavasWiwi	swrI	vyavasWAnaM	napuM																						
vyaWa	puM	vyaWa^bAXa^kleSamu	napuM																						
vyaWA	swrI	vyaWa	napuM																						
vyAXi	puM	vyAXi	napuM																						
vyayA	swrI	vyayamu^Karcu	napuM																						
vyaya	puM:napuM	vyayamu^Karcu	napuM																						
vyUDA	swrI	vyUDaM	napuM																						
vyUDa	napuM:puM	vyUDaM	napuM:napuM																						
wamas	napuM:puM	cIkati	napuM:napuM																						
wAmasa	puM	cIkati^alasawvaM	napuM																						
wAmasI	swrI	cIkati^rAwri	napuM																						
wanu	swrI	wanuvu	napuM																						
wapas	napuM	wapassu	napuM																						
wapasvin	puM	wapasvi	puM																						
wapasya	puM	wapassu	napuM																						
wAwa	puM	waMdri	puM																						
wawpara	napuM:puM	Asakwi_kalavAdu	puM:puM																						
wawwvArWa	puM:napuM	vAswavikaM^yaWArWaM	napuM:napuM																						
wawwvavix	napuM:puM	wawwva_jFAni	puM:puM																						
wejas	napuM	wejassu	napuM																						
wejasvin	puM:napuM	wejasvi^wejamu_kalavAdu	puM:puM																						
wejomaya	napuM	wejomayaM	napuM																						
wIkRNa	napuM:puM	wIkRNamu	napuM:napuM																						
woya	napuM:puM	nIru	napuM:napuM																						
wqpwa	napuM:puM	wqpwi	napuM:napuM																						
wqpwi	swrI	wqpwi	napuM:napuM																						
wqRNA	swrI	wqRNa^xappika^icCa	napuM																						
wraya	napuM:puM:swrI	mUdu	napuM																						
wrayI	swrI	mUdu_vexamulu	napuM																						
wrEguNya	puM:napuM	wrRguNya^wriguNamula	napuM:napuM																						
wrElokya	napuM	wrElokya^wrilokamula	napuM																						
wrEvixya	puM	wrivixya	napuM																						
wri	puM	mUdu	napuM																						
wriviXA	swrI	mUdu_viXamulu	napuM																						
wriviXa	napuM:puM	mUdu_viXamulu	napuM:napuM																						
wulya	puM	samAnamu	napuM																						
wumula	puM	BayaMkara	napuM																						
wuRti	swrI	saMwoRamu	napuM																						
wvac	swrI	wolu	napuM																						
wyAga	puM	wyAgaM	napuM																						
wyAgin	puM	wyAgi^xAwa	puM																						
wyAgin	puM	wyAgi	puM																						
xa	puM	iccuvAdu^iccunaxi	puM																						
xakRa	puM	samarWudu^nipuNudu	puM																						
xakRiNAyana	napuM	xakRiNAyanaM	napuM																						
xAkRya	napuM	kOSalamu^nerpu	napuM																						
xama	puM	nigrahiMcadaM^xaNdana	napuM																						
XAman	napuM	SarIramu^nivAsa_sWAnamu	napuM																						
xamBa	puM	kapatamu	napuM																						
xaMRtrA	swrI	kora_palYlYu	napuM																						
Xana	napuM	Xanamu	napuM																						
xAna	napuM	xAnamu	napuM																						
XanaFjaya	puM	XanaFjayudu	puM																						
xAnava	puM	xAnavudu^rAkRasudu	puM																						
xaNda	napuM:puM	karra	napuM:napuM																						
XanurXara	puM	XanurXarudu^vilukAdu	puM																						
Xanus	napuM	Xanussu^villu	napuM																						
xAra	puM	Barya	swrI																						
XAraNA	swrI	XariMcadaM	napuM																						
Xarma	puM	Xarmamu	napuM																						
Xarman	puM	XarmaM	napuM																						
Xarmya	puM	XarmAwmudu^puNyamu	puM																						
xarpa	napuM:puM	xarpamu^ahaMkAraM^garvaM	napuM:napuM																						
xarSana	napuM	xarSanamu	napuM																						
xarSana	napuM	cUpiMcadaM^xarSana	napuM																						
XArwarARtra	puM	XqwarARtruni_koduku	puM																						
xaSana	napuM	palYlu	napuM																						
XAwq	puM	XariMcuvAdu	puM																						
xayA	swrI	xaya	napuM																						
xeha	napuM:puM	xehamu^SarIramu^menu	napuM:napuM																						
xehAnwara	napuM	veru_SarIraM	napuM																						
xehin	puM:napuM	prANi^xehamu_kalavAdu^AwmA	napuM:puM																						
Xenu	swrI	Xenuvu^Avu	napuM																						
xeSa	puM	xeSamu	napuM																						
xeva	puM	xevudu^xevawa	puM																						
xEva	napuM:puM	xevawA_saMbaMXiwa	napuM																						
xevala	puM	waMbalYavAdu^xevawala_bommalu_ammevAdu	puM																						
xevawA	swrI	xevawa	swrI																						
xevaxawwa	puM	xevawa	puM																						
xeveSa	puM	xevawala_praBuvu	puM																						
xEvI	swrI	xevawA_saMbaMXiwa	napuM																						
xEwya	puM	rAkRasa	puM																						
XImaw	puM	jFAnamu_kalavAdu^buxXimaMwudu	puM																						
xIpa	puM	xIpaM	napuM																						
xIpwa	napuM:puM	prakASiMpabadunaxi	napuM:napuM																						
xIpwi	puM:napuM	prakAsiMcunaxi	napuM:napuM																						
XIra	napuM:puM	XIrudu	puM:puM																						
xIrGasUwrin	puM	somari	puM																						
xiS	swrI	xikku	napuM																						
xiv	swrI	xinamu	napuM																						
xivya	napuM:puM	xivyamu^xivyamEna	napuM:napuM																						
anulepana	napuM	anulepanaM^lepana_xravyaM	napuM																						
mAlya	puM:napuM	mAla	napuM:napuM																						
ambara	napuM	ambaraM^AkASaM	napuM																						
Xara	puM:napuM	XariMcuvAdu	puM:puM																						
xoRa	puM	xoRamu	napuM																						
xOrbalya	napuM	xOrbalyamu^balahInawa	napuM																						
XqRtakewu	puM	XqRtakewudu	puM																						
XqRtaxyumna	puM	XqRtaxyumnudu	puM																						
xqRti	swrI	cUdabadu	napuM																						
XqwarARtra	puM	XqwarARtrudu	puM																						
Xqwi	swrI	XEryamu^Xqwi	napuM																						
xravya	napuM:puM	xravyaM	napuM:napuM																						
xravyamaya	puM	xravyaM	napuM																						
xroha	puM	xrohaM	napuM																						
xroNa	puM:napuM	xroNudu	puM:puM																						
xrOpaxeya	puM	xrOpaxeyudu	puM																						
xrupaxa	puM	xrupaxudu	puM																						
XruvA	swrI	niScayamu	napuM																						
Xruva	puM	niScayamu^acalamu	napuM																						
Xruva	puM	sWiraM^xqDaM^Xruvudu	napuM																						
xuHKa	napuM	xuHKamu	napuM																						
XUma	puM	XUmamu^poVga	napuM																						
xUra	napuM:puM	xUraM	napuM:napuM																						
xurAsaxa	puM	poVxagUdanixi^kaRtaMwo_cerukonaxaginaxi	napuM																						
xurawyayA	swrI	asAXyamEnaxi	napuM																						
xurbuxXi	swrI	xurbuxXi	napuM																						
xurga	napuM:puM	xurgaM^kota^vipawwi^guHKaM	napuM:napuM																						
xurgawi	napuM	xurgawi	napuM																						
xuRkqw	puM:swrI	xuRta	napuM																						
xuRkqwa	napuM:puM	xuRtudu	puM																						
xuRkqwin	puM	xuRtudu	puM																						
xurlaBa	puM	xurlaBaM	napuM																						
xurmawi	napuM	xurbuxXi	napuM																						
xurmeXas	puM:napuM	xurbuxXi	napuM:napuM																						
xur-nigraha	puM	niyaMwriMcadaM	napuM																						
xuRpUra	napuM:puM	xuRtudu	puM:puM																						
xuryoXana	napuM:puM	xuryoXanudu	puM																						
xvanxva	napuM:puM	xvanxva	napuM																						
xvAra	napuM:puM	xvAra	napuM:napuM																						
xvAra	napuM:puM	xvAraM	napuM:napuM																						
xveRa	napuM	xveRaM	napuM																						
xveRtq	puM	xveRi	puM																						
xveRya	puM	Sawruvu	puM																						
xveRya	puM	xveRaM	napuM																						
xvEXa	puM:napuM	xviwvamu^reMdu_viXamulu	napuM:napuM																						
xvija	puM	reVMdusArlu_puttinavAdu	puM																						
xviviXA	swrI	reMdu_viXamulu	napuM																						
XyAna	napuM	XyAnamu	napuM																						
xyUwa	napuM:puM	jUxamu	napuM:napuM																						
xyuwi	puM:napuM:swrI	kAMwi^veVlugu	napuM:napuM:napuM																						
yajFa	puM	yajFamu	napuM																						
yajFavix	puM	yAgaviXi_welisinavAdu	puM																						
yAjin	puM	yAgamu_ceyuvAdu	puM																						
yajus	napuM	yajurvedaM	napuM																						
yakRa	puM	yakRudu	puM																						
yAma	puM	jAmu	napuM																						
yama	puM	yamudu^yamaXarma_rAju	puM																						
yaSas	napuM	yaSassu	napuM																						
yAwa	napuM:puM	prayANaM	puM:napuM																						
yawi	swrI	sAXuvu^prayawniMcadaM	napuM																						
yAwrA	swrI	yAwra^wIrWayAwra	napuM																						
yAxas	napuM	jalajaMwuvu	napuM																						
yAxava	puM	yAxavudu	puM																						
yaxqcCA	swrI	yaWecCaM	napuM																						
yAxqS	napuM:puM	eVtuvaMtixi	napuM:napuM																						
yoga	puM:puM	yoga^yogamu^XyAnamu	napuM:napuM																						
yoga	puM:puM	yoga	napuM:napuM																						
yogamAyA	swrI	yoga_mAya^viRNu_mAya	napuM																						
yogeSvara	puM	yogeSvarudu	puM																						
yogin	puM	yogi	puM																						
yoni	puM	garBASrayaM^janmasWAnaM^yoni	napuM																						
yOvana	napuM	yOvvanam	napuM																						
yoXa	puM	yoXudu	puM																						
yoxXukAma	puM	yuxXamu_ceyu_Asakwi_kalavAdu	puM																						
yuga	napuM	yugaM	napuM																						
ceRtA	swrI	pravarwana	napuM																						
cewas	napuM	manassu	napuM																						
yukwa	puM	yogyamEnaxi	napuM																						
yuX	napuM:puM:swrI	yuxXaM^yuxXam_ceyadaM	napuM:napuM:napuM																						
yuXAmanyu	puM	yuXAmanyudu	puM																						
yuXiRTira	puM	yuXiRTirudu	puM																						
yuxXa	napuM:puM	yuxXaM	napuM:napuM																						
yuyuwsu	napuM:puM	yuxXamu_ceyu_Asakwi_kalavAdu	puM																						
yuyuXAna	puM	yuyuXAnudu	puM																						
