Samskrit Word	Samskrit_GenderTelugu	Telugu_Word	Telugu _Gender
ADya		Xanikudu	
ASApASa		ASA_baMXamulu	
Sawa		nUru^vaMxa^aneka_viXamuluga	
ASaya		nivAsa_sWAnaM	
AScarya		AScaryamu	
AScaryavaw		AScaryamu	
ASu		wvaraga^veVMtane	
AXipawya		Axipawyamu	
A_paw2			
AcAra		AcAramu	
AcArya		AcAryudu	
upAsana		seva^ArAXana^upAsanamu	
Acaraw		AcaraNa	*
Af-brahman-Buvana			*
Af_KyA1			
Af_Sri1			
Af_Svas1_Nic			
Af_XA1			
Af_car1			
Af_gam1			
Af_pUr1			
Af_pax1			
Af_raB1			
Af_sWA1			
Af_sax1			
Af_viR2			
Af_viS1			
Af_vq2			
Af_vqw1			
Af_xA3			
Agama		Agama	
apAyin		apAyamu	
AgamApAyin		ASaSvawamEnaxi^janana_maraNaM_kalaxi	
AhAra		AhAramu^Bojanamu	
Ahava		yuxXamu^yajFamu	
Aho		Aho^o	
Ajya		Ajyamu^neVyyi	
AkASa		AkASamu	
sWiwa		unnaxi^niScaludu	
Ap1			
ApUryamANa		aMwata_vyApiMcunaxi	
ArAXana		ArAXana	
AramBa		AraMBamu	
Arjava		saralYwa^nijAyiwi	
ArurukRu		unnawi_ceVMxavaleVnani_icca_kalavAdu	
Arwa		xuHKamu	
As1			
AsWiwa		vasiMcina	
Asakwa		sWirudu^Asakwudu	
manas		manassu	
Asana		Asanamu	
AsurI			
Asura		Asura^rAkRasa	
niScaya		niScayamu^nirNayamu	
Aswikya		AswikawvaM	
AveSiwa-cewas			
Avqwwi		prayAyamu	
AwawAyin		SaswraprahAramu_ceyuvAdu	
AwmA		Awma	
Opamya		samarUpamu	
rawi		anurAgamu	
Awman		Awma	
Awman-BAva-sWa			
SuxXi		SuxXi	
prasAxa		prsAxamu^prasannamu^anugrahamu	
kAraNa		kAraNamu^sAXanamu	
mAyA		mAya	
para		para^iwara	
xeha		xehamu^SarIramu^menu	
saMsWa		saMsWa^vyavasWa	
saMyama		saMyamanamu^iMxriya_nigrahamu	
yoga		yoga^yogamu^XyAnamu	
agni		agni	
samBAviwa		samBAviwa^sammAniwa^gOraviwa	
vaSya		vaSamEnaxi	
viBUwi		viBUwi^Esvaryamu	
viSuxXi		viSuxXi^SuxXi	
vinigraha		nigrahamu^niyaMwramu	
wqpwa		wqpwi	
Awman-yoga			
Awmavaw		svasWa_ciwwudu	
Awyanwika		awyaXikamu^aMwamu_lenixi	
AxarSa		AxarSamu	*
Axi		Axi	
anwavaw		aMwamu	
karwq		sqRti_karwa^ceyuvAdu	
xeva		xevudu^xevawa	
Axiwya		Axiwya^Axiwyudu	
gawa		gawa^gawiMcinaxi	
varNa		varNamu^raMgu	
Axiwyavaw		Axiwyudi_lAgA	
Axya		Axyamu	
AyuXa		AyuXamu	
Ayus		Ayuvu^jIviwa_kAlamu	
sawwva		sawwvamu^Sakwi	
bala		balamu	
Arogya		Arogyamu	
suKa		suKamu	
prIwi		prIwi	
vivarXana		varXanamu	
BAR1			
BARA		BARa	
BArawa		Barawa^Barawamu	
BAs		prakASamu^kAMwi	
BAs1_Nic			
BAsvaw		prakASiMcuta	
BAva		Bava^manovikAramu	
saMSuxXi		SuxXi^svacCaM	
samanviwa		samanviwa^sambaxXa	
BAvanA		Bavana^Alocana	
BEkRya		BikRa^BikRA_samUhamu	
BIRma		BIRmudu^BayaMkara	
aBirakRiwa		rakRiMpabadina	
xroNa		xroNudu	
pramuKawa		pramuKawvamu	
Bima		Bimudu	
arjuna		arjunudu	
sama		samAnamu	
karman		karma^pani^ceyuta	
BIwa		Biwa^Bayamu	
BIwa-BIwa			
BU		BU^Bumi	
BU1			
BU1_Nic			
BUmi		Bumi	
BUwa		Buwa^prANi	
Axi		Axi^moVxalagu	
uxBava		uwpawwi^OxAryaM	
kara		kara^ceyuvAdu	
BUwa-BAvana			
Barwq		Barwa^rAju^praBuvu	
Bqw		BariMcuvAdu^kaluguvAdu	
ISa		ISa^ISvarudu^sqRtikarwa	
gaNa		gaNa^gaNamu	
grAma		grAmamu	
ijya		guruvu^xevawa^pUja	
mahaw		mahawwu^goppaxi	
Isvara		Isvarudu	* Is it Isvara
pqWak		veru^BinnaM^prawyekamu	
prakqwi		prakqwi^jIvamu^svaBAvamu	
mokRa		mokRamu	
sWa		sWiwi^sWiwi_Siludu	
sarga		sargamu^sqRti	
viSeRa		viSeRa^awyaMwa	
safGa		saMGamu^samUhamu	
BUwi		Buwi^Bagyamu^Esvaryamu	
BUyaH		marala^malYlYi	
Bagavaw		BagavaMwudu^Isvarudu	
Baj1			
Bakwa		Bakwudu	
Bakwi		Bakwi	
Bakwi-upa_hq1			
Bakwi-yoga			
Bakwimaw		Bakwudu^Bakwi_kalavAdu	
BarawaSreRTa		Barawa_SreRTudu	*
BarawarRaBa		BarawarRaBa^BarawaxeSa_rAju	
Barawasawwama		Barawasawwama^BarawaSreRTa	
Barwq			
BasmasAw		Basmam_ceyuta	
Bava		Bava^prApwi^janmamu	
apyaya		nASamu	
Bavaw		jarugunaxi^uMdunaxi	
BaviRya		BaviRya^kAgalaxi	
BaviRyaw		BaviRyaw_kAlamu^jaragaboyexi	
BayAnaka		BayAnakamu^BayaMkaramu	
BayAvaha		BayAvaha^Bayamunu_kaligiMcunaxi	
Baya		Bayamu	
aBaya		aBayamu^Bayamu_lekapovuta	
BerI		BerI	
Bexa		Bexamu	
BinnA		Binnamu	
Boga		Bogamu	
Esvarya		Esvaryamu	
gawi		gawi	
prasakwa		Asakwudu	
Bogin		Bogi^suKI^Bogamu_anuBaviMcuvAdu	
Bojana		Bojanamu	
Bokwq		Bogi^rAju^Bojanamu_ceyuvAdu	
Bokwqwva		anuBaviMcuta	
Bq2			
Bqgu		Bqgu_maharRi	
BrAwq		sahoxarudu^wodabuttinavAdu	
BrU		kanubomma	
Bram1			
Bram2_Nic			
Buj2			
Cala		mosamu^vaMcana	
Canxas		Canxassu^icca	
Cinna		Cinna^Cexana	
aBra		AkASamu^meGamu	
saMSaya		saMSayamu	
xvEXa		xviwvamu^reMdu_viXamulu	
Cix1			
ESvara		Isvaruniki_saMbaMXiMcinaxi	
ErAvawa		ErAvawamu	
GoRa		GoRa^Xvani	
Gora		GoramEnaxi^BayaMkaramu	
GrA1			
GrANa		vAsana^nAsika	
ISa		ituvaMtixi	
ISvara		Isvarudu	
ISvara-BAva			
Id1			
Ih1			
IkR1			
IxqS			
JaRa		cepa^adavi	
Ka		AkASamu	
ORaXa		ORaXamu	
Pala		Palamu	
AkAfkRin		AsiMcuvAdu^koruvAdu	
hewu		hewuvu^kAraNamu	
RWA1			
RaR		Rat^Aru	
mAsa		mAsamu	
Ranja1			
SAKA		SAKa^cettu_komma^Bujamu	
SASvawI		SASvawamEnaxi^niwyamEnaxi	
SASvawa		SASvawamu^niwyamu	
Xarman		Xarmamu	*
gopwq		rakRakudu^rAju	
SAnwa		Sanwi_poVMxinavAdu	
rajas		rajoguNamu	
SAnwi		SAMwi^Samanamu	
SArIra		SarIra_saMbaMXa	
SAs1			
SAswra		Saswramu	
SAswra-viXAna-vac1			
viXAna		viXAnamu	
viXi		viXi^niyamamu	
SEbya		Sebya	*
Siwa		Siwamu	
uRNa		uRNamu	
xuHKa		xuHKamu	
xa		iccuvAdu^iccunaxi	
SOca		Socamu^pariSuBrawa	
SOrya		Soryamu	
SUra		Surudu	
SUxra		Suxrudu	
SaMs1			
SaSAfka		SaSAfkudu^caMxrudu	
SaSin		SaSi^caMxrudu	
sUrya		sUryudu	
newra		newramu^kannu^nAyakudu	
SaSvaw		marala^niraMwaramu	
SaTa		kuwsiwudu^mUrKudu	
Sabxa		Sabxamu	
Sabxa-Axi			
brahman		brahman^paramAwma	
SafKa		SafKamu	
Safkara		Safkarudu	
Sak1			
Sama		SAMwi^upaSamanaM	
SanEH		mellagA	
SarIra		SarIramu	
SarIra-sWa			
vAk		vAkku	
vi-mokRaNa		vaxilipettuta	
yAwrA		yAwra^wIrWayAwra	
SarIrin		SarIramu_kalaxi	
SaraNa		SaraNamu	
Sarman		brAhmaNudu^saMwoRamu	
Saswra		Sawramu^AyuXamu	
Saswra-Bqwa		SaswraXArI^XariMcuvAdu	*
pANi		ceyi^haswamu	
sampAwa		pawanaM	
SawaSaH		Sawamu^vaMx^nUru	
Sawru		Sawruvu	
Sawruvaw		Sawruvu_lAgA^Sawruvu	
Sawruwva		Sawruwvamu	
SiKaNdin		SiKaMdi^nemali	
SiKarin		SiKaramu_kalaxi^parvawamu	
SiRya		SiRyudu	
Siras		Sirassu	
Soka		Sokamu	
saMvigna		uxvegaM_ceMxinavAdu	
mAnasa		manassu^mAnasa_sarovaramu	
SrI		SrI^Esvaryamu	
SrImaw		SoBanakaramEna	
SraxXA		SraxXa	
virahiwa		lenixi	
SraxXAmaya		SraxXAmaya^SraxXa_kaligiuMduta	
SraxXAvaw		SraxXa	
SraxxaXAna		SraxXA_yukwa	
SreRTa		SreRTamu	
Sreyas		Sreyassu^SuBamu	
Sri1			
Srowra		cevi^karNamu	
Axin		BujiMcedi	
Sru1			
Sruwi		vexamu^cevi	
parAyaNa		parAyaNudu^AsakwikalavAdu	
viprawipannA		viroXamu	
SuBa		SuBamu^maMgalYamu	
aSuBa		aSuBamu	
Pala		Palamu	
pariwyAgin		pariwyajiMcinavAdu^wyAgi	
SuR1_Nic			
Suc1			
Suci		Suci^SuxXaM	
Sukla		SuxXaM^weVlupu	
kqRNa		nalupu	
SvaSura		mAmagAru	
Svan		kukka	
SvapAka		caMdAludu	
Svas1			
Svewa		Svewamu^weVlupu	
SyAla		bAvamarixi	
mUla		mUlamu	
UrXvam		mIxaunnaxi^pEki	
Urjiwa		XqDamu^balamu	
XA1			
XAman		SarIramu^nivAsa_sWAnamu	
XArwarARtra		XqwarARtruni_koduku	
XAwq		XariMcuvAdu	
XImaw		jFAnamu_kalavAdu^buxXimaMwudu	
XIra		Xirudu	
XUma		Xumamu^poga	
Xana		Xanamu	
mAna		mAna^aBimAnamu	
maxa		maxamu	
anviwa		anusariMcunaxi^kUdiyunnaxi	
XanaFjaya		XanaFjayudu	
XanurXara		XanurXarudu^vilukAdu	
Xanus		Xanussu^villu	
Xarma		Xarmamu	
aviruxXa		viruxXamu	*
kAma		kAmamu^icca	
arWa		arWamu^vaswuvu^Xanamu^prayojanamu	
saMsWApanA		saMsWApanamu^sWApanamu	
Xarman-Awman			
kRewra		kRewramu^sWalamu^paMta_Bumi^	
sammUDa		mUrKudu^mUDudu	
cewas		ciwwamu^cewanamu	
Xarmya		XarmAwmudu^puNyamu	
amqwa		amqwamu^suXa	
Xenu		Xenuvu^Avu	
XmA1			
Xq1_Nic			
XqRtakewu		XqRtakewudu	
XqRtaxyumna		XqRtaxyumnudu	
XqwarARtra		XqwarARtrudu	
Xqwi		Xeryamu^Xqwi	
gqhIwA		grahiMpabadinaxi	
uwsAha		uwsAhamu	
XruvA		niScayamu	
Xruva		niScayamu^acalamu	
XyAna		XyAnamu	
para		paramu^anyamu^iwara	
XyAyaw		XyAnamu	
XyE1			
_ca			
a-BU1_Nic			
a-Cix1			
a-Socya		xuHKimpawagina^SocanIyamu	*
a-SraxxaXAna		SraxXa_kaliginaxi	*
a-SuR1			
a-cinwya		ciMwiMpawaginaxi^ciMwanIyamu	*
a-han1			
a-hiwa		hiwamu	*
a-kIrwi		kIrwi	
a-kIrwikara		kIrwiMcuta	*
a-karman			
a-klix1			
a-kqwa		kqwa^ceyabadinaxi	
a-nASin		nASamu_ceyuvAdu	
a-niwya		niwyamu	
a-parihArya		parihariMpawaginaxi^viduvawaginaxi	
a-pra_xA2			
a-prameya		yaWArxa_jFAnamu	
a-sakwa		Asakwudu	
a-sapawna		Sawruvu	
a-saw		yaWArXamu^sawyamu	
a-svargya		svargaM_koVrakuceyu_SuBakAryamu	
a-vikArya			*
a-vinASin		vinASanamu	
a-vipaSciw		paMdiwudu^vixvAMsudu	
a-vyakwa		vyakwamu^spaRtamu	
a-vyavasAyin		prayawnamu_ceyuvAdu^vyavasAyamu_ceyuvAdu^rEwu	
a-vyayA		vyayamu^Karcu	
a-vyaya		vyayamu^Karcu	
a-xah1			
a-yuj2			
aBAva		aBAvamu^lekapovuta	
aBaya		Bayamu_lekapovuta	
aBi-asUyaka		asUya_kalavAdu	*
aBi-janavaw			*
aBi-muKa		aBimuKaM^exuruga^muKamu	*
aBi_BU1			
aBi_XA1			
aBi_arc1			
aBi_asUya		asUya	
aBi_asUya1			
aBi_han1			
aBi_jFA2			
aBi_jan2			
aBi_jan3			
aBi_nax1			
aBi_rakR1			
aBi_ram1			
aBi_sam_XA1			
aBi_vi_jval1			
aBikrama		prAraMBiMcuta	
aBimAna		aBimAnamu^prema	
aBipravqwwa		paniyaMxu_nimagnudu	
aBiwaH		eVxuta^iru_prakkala	
aByAsa		aByAsiMcuta^malYlYi_malYilYi_ceyuta	
aByAsa-yoga			
aByAsa-yoga-yuj2			
aByuwWAna		aBivqxXi^peruguta	
aGa		pApamuaparAXamu	
aGa-Ayus			
aKila		samagramu^aMwayu^saMpUrNamu	
aMSa		aMSamu	
aMSumaw		sUryudu	
aNIyas		sUkRmamu^cAlA_koMcemu	
aNu		aNuvu^koMcemu	
aRmax		manavAdu	*asmax?
aRtaXA		aRta_viXamulugA	
aS1			
aS2			
aSAnwa		aSAMwi	
aSeRa		aSeRamu^aKilamu^saMpUrNamu	
aSeRawaH		saMpUrNamunuMdi	
aSru		kannIru	
pUrNa		pUrNamu^saMpUrNamu	
Akula		kRoBa^AkulaM	
IkRaNa		cUpu^xqRti	
aSuBa		aSuBamu	
aSuci		aSuci^aSuxXamu	
vrawa		vrawamu^niyamamu^AcaraNamu	
aSva		aSvamu	
aSvawWAman		aSvawWAma	
aSvawWa		rAvi_cettu	
aSvin		aSva_pAlakudu^rOwu	
aWa		waruvAwa	
aWavA		lekuMte	
aWo		waruvAwa	
aXaH		skriMxa	
aXaHSAKa			*
aXamA		aXamurAlu	
aXarma		aXarmamu	
aBiBava		wiraskAramu^parABavamu	
aXi-BUwa		parabraHmA^brahmamu	*
aXi-xEva		aXixevawa	*
aXi-xEvawa		aXixevawa	
aXi-yajFa		muKya_yAgamu	
aXiRTAna		AkramiMcuta^sWiramuga_uMduta	
aXi_RWA1			
aXi_gam1			
aXi_i2			
aXi_sWA1			
aXikAra		aXikAramu	
aXika		aXikamu	
aXikawara		aXikamu	
aXyAwma		aXyAwma^Awma_saMbaMXamEna	
aXyAwma-cewas			
aXyAwma-niwya			
saFjFiwa		perugala	
jFAna		jFAnamu	
niwyawva		niwyamu	
vixyA		vixya	
aXyakRa		aXyakRudu^aXikAri	
acalA		acalamEnaxi^Bumi^parvawamu	
acala		acalamEnaxi^Bumi^parvawamu	
prawiRTa		gOravamu^kIrwi	
acara		sWiramu^acaramu	
acinwya		AlociMcalenixi	
rUpa		rUpamu	
acira		aciramu^cirakAlamu_kAnixi	
acyuwa		ViRNuvu^sWiramEnaxi	
afga		aMgamu	
agawa-asu			*
agni		agni	
agra		agramu^eVxuta^muKyamu^moVxatixi	
ahaH		pagalu	
Agama		Agama_Saswramu	
rAwra		rAwri	
vix		uMduta^AlociMcuta	
ahafkAra		ahaMkAramu	
vimUDa		mUrKudu	
ahafkqwa		ahaMkAramu_kalavAdu	
ahan		xinamu^sUryudu^pagalu	
ahiMsA		ahiMsa	
ahiwa		ahiwamu^hiwamu_kAnixi	
aho		aho	
ajFAna		ajFAnamu	
ajFAna-ja			
samBUwa		uwpannamEnaxi^puttinaxi	
ajFAna-sammoha		AkarRaNa	
vimohiwa		mohamulounnavAdu	
ajFa		mUrKudu^ajFAni	
aja		janmiMcanixi	
ajasram		eVllappudu^niwyaM	
akAra		akAramu^pani_ceyanivAdu	
akRara		akRaramu	
samuxBava		uxBaviMcuta^puttuta	
akRaya		kRINiMcanixi^kRayamu_lenixi	
akroXa		kroXamu_lenivAdu	
alasa		somari	
alolupwva			
alpa		alpamu^wakkuva	
buxXi		buxXi^mawi^meXassu	
meXas		meXassu	
amAniwva		vinayamu	
amBas		uxakamu^nIru^AkASamu	
amUDa		weVlivEnavAdu	
amala		SuxXamu^paviwramu	
ambu		jalamu^nIru	
vega		vegamu	
ameXya		malinamu^apaviwramu	
amiwa		apAramEna^anaMwamu^eVkkuva	
vikrama		Soryamu^parAkramamu	
amqwa		amqwamu	
upama		upAyamu^polika	
uxBava		uxBaviMcuta	
amqwawva		amqwawwvamu	
amuwra		paralokamuyaMxu	
an-aBisneha		anubaMXamu^Asakwi^icca	*
an-uxvigna		uxvegamu_kalavAdu^BayamukalavAdu	
anAmaya		Arogyamu	
anArya		xuRtudu	
juRta		saMwoRaM^yukwamu	
anAxi		anAxi^niwyamu	
maXya		maXyamu	
anwa		anwamu	
anaGa		nirxoRamu^nirmalamu	
anala		agni^jaTarAgni	
ananwA		anaMwamu	
ananwa		anaMwamu	
bAhu		Bujamu	
ananwa-rUpa			
vIrya		vIrawvaM^parAkramamu^Sakwi^vIryamu	
vijaya		vijayamu^geVlupu^vijayudu	
ananwara		anaMwaramu	
ananya		ananya^samarUpamu^aBinnamu	
BAj		pujiMcuta^BAgamu	
ananya-cewas			
ananya-manas			
ananya-yoga			
aneka		anekamu	
axBuwa		axBuwamu	
xarSana		xarSanamu	
uxara		uxaramu^poVtta	
vakwra		muKamu	
newra		newramu^kannu	
ciwwa		ciwwamu	
viBrAnwa		BrAMwi_kaliginaxi	
janman		janmamu^uwpawwi	
saMsixXa		sVaBAvikamEnaxi	
nayana		nayanamu^kannu	
aneka-varNa			
xivya		xivyamu^xivyamEna	
ABaraNa		ABaraNamu	
anekaXA		aneka_viXamuluga	
anikewa		snyAsi^nivAsa_hInudu	
anirviNNa		xuHKamu_lenivAdu^viSrAMwi_lenivAdu	
anirxeSya		anirxeSyamu^nirxeSiMcalenixi	
aniwya		aniwyamu	
aniyawa		niyamamu_lenixi	
anna		annamu^AhAramu	
anna-samBava		saMBavamu^janmamu^uwpawwi	
sanwawa		eVllappudu^niraMwaramu^niwyamu^aXikamu^viswIrNamEnaxi	
anu_SAs1			
anu_Sru1			
anu_Suc1			
anu_Xi1			
anu_cinw1			
anu_iR2			
anu_man1			
anu_raFj2			
anu_sWA1			
anu_sasj1			
anu_smq1			
anu_vqw1			
anu_xqS1			
anubanXa		anubaMXamu^pASamu	
anukampA		karuNa^xaya	
anuprapanna		anusariMcuta	*
anuwwamA		SreRTurAlu^sarvowwamurAlu	
anuwwama		SreRTudu^sarvowwamudu	
anviwa		anusariMcuta	
anwa		anwamu	
anwa-gam1			
kAla		kAlamu^samayamu	
anwa-sWa			
anwaH		anwamu^lopala^civara	
anwaH-SarIra-sWa			
anwar		maXyalo^lopala	
ArAma		wota^upavanamu^AnaMxamu	
jyowi		jyowi	
anwar-suKa			
anwarAwman		aMwarAwma^paramAwma	
anwara		aMwaramu^samIpamu^lopala^	
anwavaw		aMwamuvaleV^anwamu	
anwika		samIpamu^anwamu	
anyA		anyamu^veru^iwaramu^Binnamu	
anyAya		anyAyamu^nyAyamu_lenixi	
anya		anyamu^veru^iwaramu^Binnamu	
xevawA		xevawa	
anyaWA		vere_viXamuga	
anyawra		vere_cotu^vere_praxeSamu	
ap		jalamu	
apAna		apAna_vAyuvu	
apAwra		apAwrudu^xAnamunaku_pAwrudu_kAnivAdu	
apESuna		sawyamu^nyAya_buxXi	
apa_Af_vq2			
apa_nux1			
apahqwa		apahariMcabadinaxi	
apahqwa-jFAna			
aparA		iwaramu^waruvAwa	
aparAjiwa		ajeyudu	
apara		iwaramu^waruvAwa	
aparaspara		parasparamu_kAnixi	
samBUwa		uwpannamEnaxi^puttinaxi	
aparigraha		svIkariMcakapovuta^saMgrahaNa_icca_lekapovuta	
aparyApwa		aparyApwamu^asaMpUrNamu	
api		mariyu^iMkayu	
apiwu			*
apohana		Uha^BrAMwi^woVlagiMcuta	
aprakASa		prakASamu_lenixi^prakatiMpabadanixi	
apravqwwi		pravqwwi_lenixi^nivqwwi	
aprawiRTa		aprawiRTa	
aprawima		asamAnudu	
praBAva		praBAvamu^kAMwi^sAmarWyamu	
apunarAvqwwi		maroka_janma_lenixi^mukwi	
arAga		rAga_rahiwa	
xveRawaH		xveRamuwo	
arWa			
arWin		Xanikudu^arWiMcuvAdu^yAcakudu	
arWa-kAma			
saFcaya		samUhamu	
vyapASraya		ASrayiMcuta	
arc1			
arh1			
arisUxana		arisUxanudu^Sawqvulanu_nASamu_ceyuvAdu	
arjuna		arjunudu	
arpaNa		arpaNamu^samarpaNamu	
arpiwa		arpiwamu^arpaNamu	
aryaman		sUryudu^piwqxevawa	
as1			
as2			
asWira		sWiramu_kAnixi	
asaMSaya		saMSayamu_lenixi	
asaMyawAwman		iMxriya_nigrahamu_lenivAdu	
asakwa		Asakwi_lenivAdu	
asakwa-Awman			
asakwa-buxXi			
asakwi		Asakwi_lekuMduta	
asamarWa		asamarWawa	
asaw		nijamu_kAnixi^xuRtudu	
asawya		asawyamu	
asax			
grAha		grahiMcuta^grahiMcuvAdu	
asax-kqw			
asiwa		nalupu^nIlamu^Sani_grahamu^weVlupu_kAnixi	
parama		parama^muKya^aXika	
asmaw-para			
asmax			
ASraya		Asrayamu^nivAsamu^AXAramu	
asmax-BAva			
asmax-Bakwa			
asmax-Bakwi			
anugraha		anugrahiMcuta^xaya_cUputa	
asmax-arWa			
asmax-arpaNa			
asmax-ciwwa			
asmax-gawa			
prANa		prANamu^jIvamu^prANa_vAyuvu	
asmax-karman-kqw			
asmax-manas			
parAyaNa		parAyaNudu^Asriwudu	
asmax-para			
asmax-parama			
prasAxa		prasAxamu^anugrahamu^kqpa	
asmax-sWa			
saMsWA		saMsWa	
vyapASraya		ASrayiMcuta	
yAjin		yAgamu_ceyuvAdu	
asmax-yoga			
asmaxIya		mana	
avAcya		ceVdu_mAta	
vAxa		vAxana^carcA^mAtalAduta	
avaSa		vaSamu_kAnixi^parAXInudu^svawaMwrudu	
ava_Ap1			
ava_IkR1			
ava_SiR2			
ava_gam1			
ava_jFA1			
ava_jFA2			
ava_sWA1			
ava_sax1_Nic			
ava_swamB1			
avahAsArWa		cirunavvu_koVraku	
avani		avani^Bumi^pqWivi	
pAla		pAlana^pAlakudu	
safGa		safGamu^samUhamu	
avara		pascima^nIcamEnaxi	
avyakwA		vyakwamu_kAnixi	
avyakwa		vyakwamu_kAnixi	
avyakwa-Asakwa-cewas			
Axin		Axi^moxalu	
mUrwi		mUrwi^prawima	
niXana		niXi^Asrayamu	
saFjFaka		peru	*
avyaya		avyayamu	
avyaya-Awman			
awIva		awIva^cAlA^aXikamu	
awaH		aMxuvalla^AkAraNaMgA	
awanxriwa		jAgrawa_kalavAdu	
awapaska		wapassu_vismariMcuvAdu	
awi-aSnaw			*
axBuwa		axBuwamu	
awi-inxriya			
awi-nIca			
svapna		svapnamu	
Sila		Sila^svaBAvamu	
awi_i1			
awi_ric1			
awi_uw_Sri1			
awi_vqw1			
awi_wQ1			
awra		ikkada	
awyanwa		awyanwamu	
awyarWa		awyaXikamu^awyanwamu	
axBuwa			
axamBiwva		kapatamu_lekapovuta	
axas		aMxuvalla^axi^ixi	
axqRta-pUrva			
axya		ivAlYa	
ayajFa		yajFamu_kAnixi	
ayana		ayanamu^gamanamu^mArgamu	
ayawi		yawi_kAnivAdu	
ayogawaH		veru_ceyuta^ayogyawa	
bAhya		bAhyamu^veVlupala	
sparSa		sparSa	
bAla		bAla^bAludu	
bIja		bIjamu	
praxa		xAwa	
bahiH		bayata^bAhyamu	
bahu		bahu^aXikamu	
SAKA			
uru			*
pAxa		pAxamu	
mawa		mawamu	
uxara			
bahu-vakwra-newra			
xaMRtrA		kora_palYlYu	
karAla		BayAnakamu^BayaMkara^viswqwa	
bahuXA		bahu_viXamuluga	
bahula		bahulamu	
AyAsa		prayAsa^prayawnamu^Srama	
bahuviXa		bahuviXamuluga	
bala		balamu	
balavaw		balamuwo	
banX1			
banXa		baMXamu^baMXanamu	
banXu		baMXuvu	
bawa		Sokamu^xuHKamu^Ascaryamu	
baxXa		baxXudu^kattabadinaxi	
bqhaw		goppaxi^pexxaxi	
pawi		pawi^Barwa	
sAman		mqxuwvaM^sAmavexaM	
brAhmI		sarasvawi^vAkku	
brAhmaNa		brAhmaNudu	
kRawriya		kRawriyudu	
viS		vESyudu	
brU1			
brahma-BUwa			
brahma-BUya			
brahma-agni			
nirvANa		nirvANamu^mukwi^mokRamu	
vAxin			
brahmacArin		brahmacAri	
vrawa		vrawamu^niyamamu	
brahmacarya		brahmacaryamu	
brahman		brahmamu	
brahman-BUwa			
brahman-BUya			
brahman-agni			
brahman-karman			
samAXi		samAXi^manolayamu	
brahman-nirvANa			
sUwra		sUwramu	
paxa		paxamu^Bagamu	
saMsparSa		sparSa	
brahman-uxBava			
brahman-vix			
brahman-yoga-yukwa-Awman			
buX2			
buX2_Nic			
buXa		buXudu^paMdiwudu	
buxXi			
Bexa		Bexamu	
buxXi-grAhya			
buxXi-nASa			
buxXi-saMyoga			
buxXi-yoga			
buxXi-yukwa			
buxXimaw			
cAnxramasa		cAMxramAsa^caMxruniwo_lekkiMcu_mAsamu	
cApa		Xanussu	
cAwurvarNya		cawurvarNamulu^brAhmaNaxulu	
cEla		vaswramu	
ajina		carmamu	
kuSa		kuSa^xarBamu	
uwwara		uwwaramu^uwwarapu_xikku	
cUrNiwa		cUrNamu^podi	*
ca		marayu	
ca/ca			
caFcala		caFcalamu	
caFcalawva		caFcalawvamu	
cakRus		cakRuvu^kannu^newramu	
cakra		cakramu	
haswa		haswamu	
cakrin		cakri^cakramu_XariMcuvAdu^viRNuvu^kummari	
cal1			
cala		cala^kaxaluta	
caliwa		caliwamu^kaxalika	
camU		sena	
canxramas		caMxrudu	
car1			
carAcara		carAcara	
cara		caramu^kaxulunaxi^wirugunaxi	
cawur		cAwuryamu^nAlugu	
cawur		cAwuryamu^nAlugu	
cawur-viXa		nAlugu_viXamuluga	
ceRt1			
ceRtA		ceRta	
cekiwAna		cAndramAsa	
cew		atula_ayinaco	
cewanA		cewanamu	
cewas		ciwwamu^manassu	
ci1			
cikIrRu		ceya_icca_kalavAdu	
cinw1			
cinwA		ciMwa^walapu^xigulu^Alocana	
ciwraraWa		sUryudu	
ciwwa		ciwwamu	
cyu1			
eXas		iMXanamu^samiXa	
ekA			
ekAgra		ekAgrawa	
ekAkin		ekAki	
ekAnwa		ekAMwamu	
ekAnwika			
eka		oVkati	
eka-Bakwi			
aMSa		aMSamu	
akRara		akRaramu	
eka-sWa			
ekawva		aBexamu^oVkatigA_uMduta	
eva		itulane^I_viXamugane	
evam		ixi_mAwrameV	
evam-rUpa			
evam-viXa			
ewAvaw			*
ewax		ixi	
ewax-yonin			
gANdIva		gANdIvamu	
gAwra		avayavamu^SarIramu	
gAyawrI		gAyawri	
gE1			
gQ2			
gahanA		xattamEna^guha^kaRtamu	
gajenxra		gajeMxrudu	
gam1			
ganXa		ganXamu^vAsana	
ganXarva		ganXarvudu	
yakRa		yakRudu	
asura		asurudu^rAkRasudu	
sixXa		sixXi_kalavAdu^sixXiMcinaxi	
garBa		garBamu	
garIyas		GanamEnaxi	
gawa		gawa^gawiMcinaxi	
Agawa		poMxabadinaxi	
asu		prANamu	
rasa		rasa	
safga		safgamu^melanamu	
sanxeha		saMxehamu	
vyaWa		vyaWa^bAXa^kleSamu	
gawi		gawi^calanamu^poka	
gaxin		gaxAXAri	
geha		gqhamu^illu^SarIramu	
gir			*
glAni		alasata	
go		Avu	
govinxa		goviMxa	
grah1			
gras1			
grasiRNu		winuvAdu^mriMguvAdu	
guNa		guNamu	
guNa-Bokwq			
guNa-anviwa			
awIwa		awIwamu^gadacinaxi	
guNa-karman			
viBAga		viBAgamu	
viBAgaSaH		viBAgamunuMdi	
guNa-pra_vqX1			
safKyAna		safKya	
guNa-safga			
guNa-sammUDa			
BexawaH		Bexamuvalana^Bexamu	
guNamayI		saxguNamulu_kalavAdu	
guNamaya		saxguNamulu_kalavAdu	
guNawaH		guNamulaku_anuguNaMga	
gudAkeSa		arjunudu	
guhya		guhyamu^rahasyamu	
guhya-wama			
guhyawama			*
guhyawara			
guru		guruvu^baruvu^muKyamu	
hA2			
hAni		hAni	
ha		ha	
han1			
han1_Nic			
hanwa		ayyo	
hanwq		hiMsiMcuvAdu	
hanyamAna		caMpabaduta	
harRa		harRamu	
Soka		Sokamu	
amarRa		asahanaSilamu^kopamu	
uxvega		uxvegamu	
hari		hari	
haswa		haswamu	
haswin		woVMdamukalaxi^enugu	
havis		havis^homa_xravyamu	
haya		hayamu^gurramu	
he		he	
hewu		hewuvu	
hewumaw			*
hi		niScayamu	
hiMs1			
hiMsA		hiMsa	
Atmaka		svaBAvikamu	
himAlaya		himAlayamu	
kAmyA		kAmyamu^korika	
hq1			
hqR1			
hqRIkeSa		hqRIkeSudu^viRNuvu	
hqRta		harRamu	
roman		romamu^cinna_veVMtruka	
hqw		hariMcunaxi	
hqwa-jFAna			
hqx		manassu^hqxayamu^Cawi	
xeSa		xeSamu	
hqxaya		hqxayamu	
xOrbalya		xOrbalyamu^balahInawa	
hqxya		manassuku_hiwamEnaxi	
hrI		siggu^lajja	
hu1			
i1			
iR2			
iRta		iRtamu	
aniRta		ayiRtawa^ayiRtamu	
upapawwi		kAraNaM^xqRtAMwamu	
iRta-kAma-Xuk		korikalu_wIrcedi_Xenuvu	
iRu		bANamu	
icCA		icCa^iRtamu^korika	
icCA-xveRa-samuwWa		icCa_xveRamulawo_uxBaviMcinaxi	
ifg1			
iha		ihamu^I_lokamu	
ijyA		yAgamu^xAnamu	
ikRvAku		ikRvAku_vaMSaM	
inxriyArWa		inxriya_viSayamu	
inxriya		inxriyamulu^wvagAxi_inxriyamulu	
ArAma		vanaM^wota^krIdA_praxeSamu	
gocara		gocaramu	
grAma		samUhamu	
iva		valeV	
iwaH		iMwakaMteV^ikkada_nuMdi^ika_mIxa	
iwara		iwara	
iwi		ani^itlu^I_viXaMgA	
ixAnIm		ippudu	
ixam		ixi^I	
jAgq1			
jAhnavI		jAhnavI^gaMga	
jAwa		puttinaxi^samUhamu	
jAwi		kulamu^puttuka^sAmAnyamu	
jAwu		oVkappudu^niMxa	
jFA1			
jFA2			
jFAnAgni		jFAnAgni	
jFAna		jFAnamu	
xagXa		kAlcabadinaxi	
jFAna-asi			
jFAna-avasWiwa-cewas			*
jFAna-cakRus			
jFAna-gamya			
nirXUwa		viduvabadinaxi^Upabadinaxi	
kalmaRA		kalmaRamu^pApamu	
saFCinna		CinnABinnamu_ceyu^mukkalu_ceyu	
saMSaya		saMSayamu	
safga		safgamu^kaliyunaxi^kUduta	
vijFAna		vijFAnamu^jFAnamu	
nASana		nASanamu	
wqpwa		wqpwi_poMxinaxi	
xIpa		xIpaM	
xIpiwa		prakASiMpabadinaxi	
vyavasWiwi		vyavasWAnaM	
plavana		wariMcuta^Ixuta	
jFAnavaw		jFAnamu_kaligiuMduta	
jFAnin		jFAni	
jIrNa		jIrNa^vqxXudu^SiWilamu^pAwaxi	
jIv1			
jIv1_san			
jIva		jIvamu^prANaM	
jIvana		jIvanamu^brawuku_weruvu	
jIviwa		jIviwamu^brawuku^prANaM	
jaGanya		civarixi^nIcudu^aXamudu	
jagaw		jagawwu^lokaM^prapaMcaM	
nivAsa		nivAsamu	
jan3_Nic			
janArxana		janArxanudu^viRNuvu	
jana		janaM	
aXipa		aXipawi	
saMsax		saBa	
janaka-Axi		janakudu_moxalugu	
janman		uwpawwi^puttuka^uxBavamu	
banXa		banXanaM^SarIraM	
vinirmukwa		viduvabadinaxi	
mqwyu		mqwyuvu	
jarA		musaliwanamu^muximi	
vyAXi		vyAXi	
xoRa		xoRamu	
anuxarSana		xaggaragA_cUcuta^nirIkRiMcuta	
janwu		janwuvu	
japa		japamu	
maraNa		maraNamu	
jaya		jayamu	
ajaya		parAjayaM^ajayaM	
jayaxraWa		jayaxraWudu	
ji1			
ji1_san			
jijFAsu			
jiwa		jayiMpabadinaxi	
juR2			
jvalana		prakAsiMcunaxi^maMta	
jvalaw		prakASamu_kalaxi	
jyAyas		SreRTudu^agrajudu^vqxXudu	
jyAyasI		SreRTurAlu^agrajurAlu^vqxXurAlu	
jyowis		jyowi^prakASamu^agni^velugu	
kASirAja		kAsirAju	
kASya		kASi_rAjyapu	
kAfkR1			
kAla		kAlamu	
anala		agni^jaTarAgni	
sanniBa		samAnamu	
kAma		kAmaM	
Boga		Bogamu^suKamu	
hEwuka		hewuvAxamu_kalavAdu	
kAma-ipsu			Is it Ipsu ?
kAma-kAma			
kAmin		kAmiMcuvAdu^korika_kalavAdu	
kAma-kAra		yaWeRtaMgA_pravarwiMcuvAdu	
parAyaNa		aBIRtamu^Asakwi	
uxBava		uxBaviMcunaxi	
viyukwa		veru_ceyabadinaxi^vicCinnamEnaxi	
rAga		rAga^xuRta^mAwsaryamu	
bala		balaM	
anviwa		anusariMcunaxi	
vivarjiwa		vaxilipettabadinaxi^ivvabadinaxi	
safkalpa		safkalpamu^icCASakwi^mAnasika_xqDawvaM	
varjiwa		vaxilipettabadinaxi^ivvabadinaxi	
upaBoga		upaBogaM^suKaM	
parama		praXAnaM^AxyaM	
kAmakAra		yaWeRtaMgA_pravarwiMcuvAdu	
kAmya		korika^koraxaginaxi	
kAraNa		kAraNaM^hewuvu	
kArpaNya		kqpaNawvaM	
upahawa		nASamu_poVMxinaxi^gAyapadinavAdu	
svaBAva		svabAvaM	
kArya		kAryaM^pani	
akArya		ceddapani	
karwqwva		karwqBAvaM	
kAya		kAyamu^Sariramu^kAya	
grIva		kaNTamu	
kleSa		kleSaM^kaRtaM^vexana^xuHKaM	
kIrwi		kIrwi	
kOSala		kuSalawa^prasannawa	
kOmAra		kumArAvasWa	
kOnweya		kuMwI_puwrudu	
kRAnwi		gawi^gamanaM	
kRAwra		kRawriya_jAwi	
kRI1			
kRINa		SakwihInaM^xurbalaM	
kalmaRa		kalmaRaM^malinaM	
kRaNa		kRaNaM	
kRam1_Nic			
kRamA		kRama^pqWvI^sahanaM	
kRamin		sahanaSIludu^kRamiMcuvAdu	
kRara		Bumi^meGamu	
kRawriya		kRawriyudu	
kRaya		kRaya^nASamu	
kRemawara		kRemaM^rakRaNa^suKaM	
kRewra		Bumi^sWAnaM^paMtaBUmi	
kRewra-jFa		nerpari^jIvAwma	
saMyoga		saMyogaM^kalayika^saMgamaM	
kRewrin		BUsvAmi^Barya_kalavAdu	
kRip2			
kRipram		SIGraM^vegaM	
kRuxra		"sUkRmaM,xuRta,krUra"	
kUrma		wAbelu^viRNu_avawAraM^	
kUtasWa		parabrahma^Awma^kAlamuwo_mAranixi	
kaSmala		malinaM^kaSmala^pApamu^aSuxXaM	
kaWa1			
kaWam		elA	
kacciw		kaxa	
kal2_Nic			
kalevara		kalevaraM^SarIraM	
kalpa-Axi		kalpAxi^kalpAraMBamu	
kalpa-kRaya		sqRti_nASamu^kalpa_kRayamu	
kalyANa-kqw		maMgalYapraxaM^lABaxAyakaM	
kamala-Asana-sWa		kamalAsanudu^kamalamu_AsanamugA_kalavAdu	
kamala-pawra-akRa		kamalapawrAkRudu^kamalapawramu_vaMti_newramu_kalavAdu	
kanxarpa		manmaWudu	
kapi-Xvaja		kapiXvajudu	
kapila		kapila_varNaM	
karNa		karNudu	
karaNIyA		ceyabadAli	
karaNa		kriya^Xarmika_kqwyaM	
wyAga		wyAgamu	
coxanA		prerepiMcuta	
safgraha		safgrahaM^sekariMcu	
karmajA		karmalanuMci_puttinaxi	
karmaja		karmalanuMci_puttinaxi	
karman		kAryaM^PalaM	
Asafga		ASrayaM^anurAgaM^sAhacaryaM	
prepsu		poVMxavalenani_korika_kalavAdu	
saMyoga		kalayika^saMgamu	
wyAgin		wyAgi^xAwa	
banXana		banXanaM^kattu	
saFjFiwa		peru_galaxi	
safgin		snehaSIludu	
sannyAsa		sannyAsamu	
karmin		pani_ceyuvAdu	
karuNa		karuNa^kanikaramu	
karwq		ceyuvAdu_sqRtikarwa	
katu		gAtu^kAramu	
Amla		pulupu	
lavaNa		lavaNamu^uppu	
awyuRNa		eVkkuva_vedi^xahiMcunaxi	
wIkRNa		wIkRNamu	
rUkRa		karuku^paruRaM	
vixAhin		kAlcuvAdu	
kavi		kavi^paMdiwudu	
kawaraw			*
kaxAcana		oVkappudu	
kaxAciw		oVkappudu	
keSava		keSavudu	
keSiniRUxana		keSiniRUxanudu^viRNuvu	
kevala		kevalaM	
kiFcana		koVMceVM	
kiFciw		koVMceVM	
kilbiRa		wappu^pApamu^ceVdu_viRayaM	
kim		emiti	
AcAra		AcaraNaM^vyavahAraM	
kirItin		arjunudu^kirItamu_XariMcuvAdu	
klEbya		pirikiwanamu^klEbyaM	
kleSa		xuHKaM^kaRtaM^bAXa	
klix1_Nic			
kq3			
kq3_Nic			
kqR1			
kqR1_Nic			
kqRNa		kqRNudu^nalupu^xrOpaxi^kqRNA_naxi	
kqRi		kqRi^sexyamu^Srama^vyavasAyamu	
gO			*
rakRya		rakRiMpaxaginaxi	
vANijya		vANijyaM^vyApAramu^varwakamu	
kqp1			
kqpA		kqpa^xaya^kanikaraM	
kqpa		kqpa^xaya^kanikaraM	
kqpaNa		kqpaNudu^loBi^kuwsiwudu	
kqw1			
kqwa		ceyabadinaxi^karma_PalaM^oka_yugamu	
aFjali		aFjali^cewulu_jodiMci_namaskariMcuta	
anwa		aMwamu	
kqwya		ceRta^kAryamu^ceyuta^pani	
kqwsna		aMwayu^jalamu	
kqwsnavaw		aMwayu^jalamu	
krUra		krUra^nirxaya^hiMsiMcuta	
krawu		yajFamu^ceyabadunaxi	
kriyA		ceRta^pani^kriya	
kroXa		kroXamu	
kuSala		kuSalaM	
kula		kulaM	
kulaGna		kulamunu_nASamu_ceyuvAdu	
kunwi-puwra		kunwi_puwrudu	
kunwiBoja		kunwiBojudu	
kuru		kuru_xeSaM	
pravIra		uwkqRta yoXudu^pUjyudu	
vqxXa		vqxXudu^pexxaxi	
kurunanxana		kurunaMxanudu	
kurusawwama		kurusawwamudu^kuruSreRtudu	
kusumAkara		uxyAnaM^vasaMwa_qwu	
kuwaH		ekkadanuMdi^eMxuku	
kvaciw		appudappudu^koMceM	
lABa		lABaM	
lABa-alABa		lABAlABaM	
lAGava		lAGavaM^culakana	
laB1			
laGvASin			*
lakRaNa		lakRaNaM	
lifga		lifgaM	
lih1_san			
lip1			
loBa		loBaM^Asa	
loka		lokaM	
wraya		mUdu	
lubXa		loBi	
lupwa		lopiMcinaxi^lupwaM	
piNda		piNdaM	
uxakakriyA		jalawarpaNaM^uxakakriya	
mA		walli^lakRmi^nivAraNamu	
mAXava		mAXavudu	
mAhAwmya		mAhAwmyaM^goppaxanaM	
mAmaka		mA_vAdu^mAxi	
mAmikA		mA^mAxi	
mAna		AxaraNa^ahaMkAraM^prawiRtA	
apamAna		anAxaraNa	
mAnasa		manassu	
mAnava		mAnavudu^maniRi^manu_saMbaMXa	
mAnuRI		Ada_maniRi	
mAnuRa		maniRi^manavudu^puruRudu	
mArgaSIrRa		mArgaSira_mAsaM	
mAruwa		vAyuvu^gAli	
mArxava		mqxuwvaM^sukumArawa^meVwwana	
mAsa		mAsaM^neVla	
mAwq		walli^Avu^lakRmi	
mAwrA-sparSa		Bowika_saMparkaM	
mAwula		menamAma	
mAyA		mAya	
mEwra		mEwri^miwrudu^sneha_BAvaM	
mOna		mOnaM	
mOnin		mOnaM^mOnavrawaM_AcariMcevAdu	
mUDa		mUDudu^mUrKudu^ajFAni	
yoni		garBASrayaM^janmasWAnaM	
mUla		mUlamu^moVxalu	
mUrXan		mUrXamu^sirassu^wala	
mUrwi		mUrwi^SarIraM^prawima	
maNi		ABURaNaM^rawnamu	
gaNa		gaNamu^samUhamu^vargamu	
maXusUxana		maXusUxanudu	
maXya		maXya	
mahAbAhu		mahAbAhu^balamEna_Bujamulu_kalavAdu	
mahAn-SafKa		mahASaMKaM	
mahAn-raWa		mahAraWudu	
mahAnuBAva		mahAnuBAvudu	
mahAraWa		mahAraWudu	
mahAwman		mahAwmudu	
mahI		Bumi^mahi	
mahIkRiw		rAju^praBuvu	
mahaw-aSana		vyApwi^goppa_Akali	
bAhu		Bujamu	
iRvAsa		villu^Xanussu^vilukAdu	
pApman		pApamu	
qRi		qRi	
mahawI		goVppaxi^nAraxuni_vINa	
mahax		goVppa	
mahax-Awman			
BUwa		paFcaBUwamulayaMxu_oVkati	
yogeSvara		yogeSvarudu	
maheSvara		maheSvarudu	
mahiman		goppawanamu^Esvaryamu	
makara		makaramu^moVsali	
mala		malamu	
man1			
man2			
manIRin		buxXimaMwudu^vixvAMsudu	
RaRTa		Aravaxi	
manmaya		nAnuMci	
manoraWa		manoraWaM	
manu		manu^buxXi	
manuRya		maniRi^manuRya_jAwi	
loka		lokaM	
manwra		maMwraM	
hIna		hInamu^wakkuvEnaxi	
manxa		maMxa^paSu_samUhamu	
marIci		sUryudu^kiraNamu	
maraNa		maraNaM	
maruw		vAyuvu^gAli^	
marwya		naSiMcunaxi^BUlokaM^mAnavudu	
maw		nA^nAnuMdi	
mana		manassu	
mawa		mawaM^aBiprAyaM^sammawaM	
mawi		mawi^buxXi^icCa	
mawwa		maxamu^mawwu	
maxa		maxamu^mawwu	
meXA		meXassu^XAraNA_Sakwi^buxXi	
meXAvin		meXAvi	
meru		meru_parvawaM	
miSra		miSraM	
miWyA		miWya	
miwra		sUryudu^miwrudu	
ari		Sawruvu	
pakRa		prakka^paxihenu_rojulu	
xroha		xrohaM	
moGa		vyarWaM^nirarWakaM	
ASa		Asa	
moha		mohaM	
jAla		jAlaM	
samAvqwa		cuttabadinaxi	
kalila		aCexya^xattamEna	
mohana		mohiMpa_ceyuvAdu	
mohinI		mohinI	
mokRa		mokRamu	
mq1			
mqga		mqgaM	
mqgenxra		mqgenxrudu	
mqwa		mqwa^maraNaM^cAvu	
mqwyu		mqwyuvu^yamudu	
saMsAra		saMsAraM	
sAgara		sAgaraM	
varwman		mArgaM^wrova	
muKa		muKaM	
muKya		muKyaM	
muc1			
muc1 _Nic			
muh1			
muh1_Nic			
muhuH		mAtimAtiki	
mukwa		mukwi_noVxuta	
mumukRu		mokRaM_korevAdu	
muni		muni	
mux1			
nASa		nASiMcu	
nASana		nASanamu	
nAga		nAga^pAmu^enugu	
nAman		peru	
nAnA		nAnA^viviXamEna^anekaM	
praharaNa		kottuta^AyuXaM	
Akqwi		Akqwi^rUpaM	
viXa		viXamu	
nArI		nAri	
nAraxa		nAraxudu	
nAsA		mukku	
aByanwara		maXyana^lopala	
cArin		AcariMcuvAdu^saMcariMcuvAdu	
agra		moVxatixi^muKyamu	
nAyaka		nAyakudu	
nERTikI		niRTa_kalavAdu	
nERkarmya		kriya_hInawa^niRkAma_karmalu_ceyuta	
nERkqwika			*
nI1			
nIwi		nIwi	
nO		nAva^oda	*
na		kAxu^vaxxu	
ASriwa		Asrayamu_poVMxinavAdu	
Aximaw		praWamam^AraMBaM	
na-Axiwva			*
na-Baj1			
SASvawa		SASvawaM	
vihiwa		viXiMpabadinaxi	
Sakwa		Sakwudu^samarWudu^prayojaku	
Sama		Sanwi^mUgaBAvaM	
SraxxaXAna		SraxXAyukwudu	
SuSrURu		vinavalenani_korika_kalavAdu	
Suci		svacCa^SuxXaM	
Xruva		sWiraM^xqDaM^Xruvudu	
aBisanXa		vaFcakudu^niMxakudu	
ahaMvAxin			*
ahafkAra		ahaMkAraM	
anyA		BinnaM^veru	
gAmin		velYlYvAdu	
apekRa		apekRa^korika^kAMkRa	
na-asUya1			
asUyu		asUyAparudu	
na-ava_Ap1			
na-ava_IkR1			
na-ava_lok2			
mAniwA		aBimAnaM_kalavAdu^pUjiMpabadinavAdu	
buxXi		buxXi	
cApala		capalawvaM	
cira		cira_kAlaM^cAlA_kAlaM6^pAwa	
hEwuka		hewuvAxi	
na-iR2			
na-jFA2			
na-kalmaRa		kalmaRamu	
na-kq3			
buxXiwva		buxXi^jFAnaM	
na-kuSala		kuSalaM	
palAyana		pAripovuta	
parimeyA		koVluvaxaginaxi^parimiwa	
na-pra_Ap1			
prameya		yaXArWa_viRayaM^prameyaM	
prawIkAra		prawIkAraM^viroXaM	
priya		priyaM	
rawi		AnanxaM^prema^Bakwi	
saMSaya		saMSayaM	
sammUDa		mUrKawvaM^mUDawvaM	
sammoha		ajFAnaM^mUrKawvaM	
sawkqwa		pUjiwa^AwiWyaM	
sixXi		sixXi^saPalawvaMsaMpUrNaM	
sqRtAnna			*
upakArin		upakAri^upakAraM_ceyuvAdu	
uxvega		uxvegaM	
vaSa		vaSaM	
pUrvaka		pUrvakaM	
na-vi_Baj1			
na-vi_jFA2			
na-vi_naS1			
vikampa		caMcala^asWiraM^vaNukuta	
vixvas		vixvAMsudu	
vyaBicAra		viruxXa_AcaraNaM^ullaMGanaM	
vyaBicAriNI		vyaBicAriNi	
wawwvArWavaw		vAswavikaM^yaWArWaM	
xakRiNa		xakRiNaM	
xroha		xrohaM	
xveRtq		xveRi	
yaSas		yaSassu	
yaWAvaw		yaWAviXaM^niyamAnusAraM	
na-yuj2			
naBas		AkASaM	
spqS		sparSa^wAkuta	
naRta		naRtaM	
naS1			
naS1_Nic			
aBiRvafga		aBiruci^awyAsakwi^sparSa	
nacirAw		naciraM^kRaNikaM	
nakRawra		nakRawraM	
nakula		nakuludu^muMgisa^kulaM_lenivAdu	
nam1			
namaH		namaskAraM^xaMdamu	
namas_kq3			
namasya		pUjanIya^arcanIya^saparya	
narAXama		narAXamudu	
narAXipa		narAXipawi	
nara		narudu	
aXama		aXamudu	
vIra		vIrudu	
pufgava		puMgavudu^SreRtudu	
naraka		narakaM	
nava		nava^wommixi	
navan		nava^wommixi	
xvAra		xvAra	
naxI		naxi	
vAwa		vAyuvu^vAwa_xoRaM^vAwa	
ni-yuj2			
niHSreyasa		niHSreyassu^Sreyassu_kAnixi	
niHspqha		niHspqha^spqha_lekuMduta	
niRTA		niRTa	
niSA		rAwri^pasupu	
niScalA		niScalaM	
niScaya		niScayaM	
niSciwa		niSciwaM^niScayiMpabadina	
niXAna		uMcuta^saMpaxa^niXi	
niXana		niXanudu^xarixrudu^bIxavAdu	
ni_banX1			
ni_buX2			
ni_car1			
ni_gam1			
ni_grah1			
ni_han1			
ni_miR1			
ni_rah1			
ni_ruX1			
ni_vas1			
ni_viS1_Nic			
ni_vqw*1			
ni_vqw1			
ni_yam1			
ni_yam3			
ni_yuj2			
nibanXa		nibanXanaM	
nigraha		nigrahaM	
nimiwwa		nimiwwaM^kAraNaM	
mAwra		mAwra	*
ninx1			
nir-ASis		nirASissu^ASIssulu_lekapovuta	
nir-ASraya		nirASrayaM^ASrayaM_lekapovuta	
nir-AhAra		nirAhAra^AhAraM_lekapovuta	
nir-agni		niragni^agni_howraM_ceyanivAdu	
nir-ahafkAra		nirahafkAri	
nir-guNa		nirguNa^mUrKudu^paramAwma	
nir-malawva		SuxXaM	*
nir-mama		mamakAra_hInudu	
nir-vEra		vEraM_lenixi	
nir-vikAra		nirvikArudu^vikAramu_lenivAdu	
nir-xoRa		nirxoRaM^nirxoRi^xoRaM_lekuMduta	
nir-xvanxva		rAgaxveRamulu_lenivAdu	
nir-yoga-kRema			*
nir_IkR1			
nirguNawva		nirguNa^mUrKudu^paramAwma	
nirmAna		aBimAnaM_lekapovuta	*
nirmala		nirmalaM^svacCaM^SuxXaM	
nirmama		mamakAraM_lekapovuta	
nirvANa		nirvANaM^mokRaM	
paramA		parama^muKya^SreRTa	
nirvexa		nirvexaM^nirASa^vErAgyaM	
nirxeSa		nirxeSaM^AjFa	
nis-spqha		nispqha^nirASa	
nis-wrEguNya		anAsakwudu^wriguNamulu_lenivAdu	
nivAsa		nivAsaM	
nivqwwi		nivqwwi^viramiMcuta^nivAraNamu	
niwya		niwyaM	
niwya-aBi_yuj2			
sawwvasWa		sawwvaguNa_viSiRta^uwwama^SreRTa	
niwya-yuj2			
niwyaSaH		niwyaM^saxA	
niwyavErin		niwyavEri	
nixrA		nixra	
Alasya		alasawvaM	*
pramAxa		pramAxaM^xurGatana	
uwWa		melukovataM^pEki_levatam	
niyama		niyamaM^prawijFa^nigrahaM	
niyawa		niSciwa^sWira	
AhAra		AhAraM^apaharaNaM	
no		kAxu^vaxxu	*
nq			*
nq-loka			
nu		kUda	*
nyAsa		sWApiMcadaM^xAcataM	
nyAyya		nyAyaM^uciwaM^sAmAnyaM	
oRaXI		ORaXaM	
ofkAra		ofkAraM	
ojas		Sakwi^balaM^prakASaM	
om		Om	
pAFcajanya		pAFcajanyaM	
pANdava		pANdava	
anIka		sEnyaM	
pANdu		pANdu_rAju	
puwra		puwrudu	
pApa		pApaM	
kqwwama		CexiMpabadinaxi	*
pApman		pApaM^aparAXaM^xuRta	
pArWa		pArWudu^kuMwI_puwrudu	
pAruRya		nirxaya^kaToraM^paruRaM	
pAvaka		agni^sUryudu	
pAvana		pAvanaM^paviwraM^paviwraM_ceyuta	
pAwra		pAwra^vixyA_guNamu_kalavAdu	
pIdA		pIda^kaRtaM^vexana^karuNa	
pONdra		pONdra_xeSaM	
pOruRa		pOruRaM^parAkramaM^puruRa_BAvaM	
pOrvaxehika		pUrvajanma_pApapuNyamulu	
pOwra		pOwrudu^manumadu^kodudu_koduku	
pU1_Nic			
pU2			
arha		arhawa^waginavAdu	
pUjya		pUjiMpaxaginaxi	
pUruRa		puruRudu^maniRi^Awma	
pUrva		wUrpu	
aByAsa		aByAsaM^alavAtu	
pUrvam		pUrvaM	
pUrvawara		pUrvaM	
pUwa		SuxXaM_ceyuta^pUcuta^pUwa	
pUwi		xurgaMXaM	
paFcama		paFcamaM^Exava	
paFcan		paFca^Exu	
paNavAnaka		paNavAnakaM	
gomuKa		gomuKaM	
paNdiwa		paMdiwudu^vixvAMsudu	
paWin		mArgaM^xAri^wrova	
pac1			
pakRin		pakRi^rekkalu_galaxi	
parA			*
parNa		parNaM	
para		para^iwara	
param		para^iwara^BinnaM	
paramA		muKya^SreRTaM^praXAnaM	
paramAwman		paramAwma	
parama		muKya^SreRTaM^praXAnaM	
iRvAsa		villu^Xanussu	
parameSvara		parameSvarudu	
paramparA-pra_Ap1			
paranwapa		SawrunASakudu	
parasparam		parasparaM	
paraswAw		waruvAwa^pimmata	
parawaH		waruvAwa^pimmata	
parawara		waruvAwa^pimmata	
pari-jFAwq		jFAni^buxXimAn	
pariNAma		pariNAmaM^mArpu^parivarwanaM	
pari_SuR1			
pari_ava_sWA1			
pari_cakR1			
pari_cinw1			
pari_kQw1			
pari_kliS2			
pari_mArg1			
pari_sam_Ap1			
pari_upa_As1			
pari_wyaj1			
pari_xah1			
pari_xiv1			
paricarya		seva	
Awmaka		svaBAva	
parigraha		svIkariMcuta^cuttumuttuta	
paripanWin		Sawruvu^ahiwudu	
paripraSna		praSna^kuSala_praSna	
pariwrANa		saMrakRaNa	
pariwyAga		pariwyAgaM^wyAgamu_ceyuta	
parjanya		uwpAxanaM^kaligiMcuta	
paryApwa		paryApwaM^samApwaM	
paryuRiwa		pAcipoyinaxi^bahukAlaM-uMcabadinaxi	
pavana		vAyuvu^gAli^pavanaM	
paviwra		paviwraM	
paw1			
paw1_Nic			
pawafga		pakRi^sUryudu^pawafgaM	
pawra		pawraM^Aku^xaswAveju	
paxa		adugu^sWAnaM^paxamu	
paxma		paxmaM^wAmara	
piwAmaha		piwAmahudu^wAwa	
piwq		piwq^waMdri	
vrawa		vrawaM^niyamaM	
pqRTawaH		venukanuMdi	
pqWak		veru	
pqWakwva		veru	
pqWivI		pqWivi^Bumi	
pqWivIpawi		rAju	
prAFjali		aFjali	
prANAyAma		prANAyAmaM	
prANa		prANa_vAyuvu^prANaM^jIvaM	
apAna		apAna_vAyuvu	
gawi		gawi^gamanaM	
prANa-apAna-sam_Af_yuj2			
prANin		prANi	
prAXAnya		prAXAnyaM^muKyaM	
prAk		wUrpu^muMxara^pUrvamu	
prAkqwa		sAmAnya^sAXAraNa^prAkqwa_BARa	
prIwa		prIwi	
prIwi		prIwi	
prIyamANa			*
praBA		praBa^veVlugu^wejassu	
praBava		puttunaxi	
praBaviRNu			
praBu		praBuvu^rAju^aXipawi^svAmi	
praC1			
praNava		praNavAkAraM^oMkAraM	
praNaya		praNayaM^vivAhaM^snehaM^prema	
praNipAwa		praNAmaM^namaskAraM6aBivAxanaM	
praSAnwa		praSAnwawa	
praSaswa		SreRTa^praSaMsanIyaM	
praWiwa		praKyAwi^prasixXi	
pra_Af_raB1			
pra_Ap1			
pra_Ap2			
pra_BAR1			
pra_BU1			
pra_Nam1			
pra_XmA1			
pra_arWa1			
pra_brU1			
pra_hA2			
pra_han1			
pra_has1			
pra_hqR1			
pra_i1			
pra_jFA2			
pra_kAS1_Nic			
pra_lI1			
pra_lap1			
pra_muc1			
pra_naS1			
pra_nam1			
pra_ni_XA1			
pra_pax1			
pra_sU1			
pra_sU2			
pra_sWA1			
pra_sac2			
pra_sax1			
pra_sax1_Nic			
pra_siX3			
pra_sq1			
pra_u1			
pra_vac1			
pra_vax1			
pra_viS1			
pra_vi_Baj1			
pra_vi_lI1			
pra_vqX1			
pra_vqw1			
pra_vyaW1			
pra_wap1			
pra_xIp1			
pra_xiS1			
pra_xqS1			
pra_xuR1			
pra_xviR1			
pra_yA1			
pra_yam2			
pra_yuj2			
prahlAxa		prahlAxudu	
prajA		prajalu	
prajA-pawi		prajApawi^rAju	
prajApawi		prajApawi^rAju	
prajFA		prajFa^buxXi	
prajana		uwpAxanaM^cUlu^garBamu	
prakASa		prakASaM	
prakASaka		prakASakudu^veVlugu_iccuvAdu	
prakIrwi		kIrwi^prasixXi^yaSassu	
prakqwi-ja		prakqwi_sixXaM	
prakqwi-sWa		svABAvikaM^sahajaM	
samBava		saMBavaM^uxBavaM	
pralIna		naRtamEnaxi^cewanamu_lenixi	
pralaya		pralYyaM	
pramAWin		pIdiMcuvAdu	
pramAxa		pramAxaM	
pramuKa		pramuKudu^muKyaM^SreRTaM	
prapaSyaw		buxXi^jFAnaM	*
prapiwAmaha		muwwAwa	
prasAxa		prasAxaM^anugrahaM^nEvexyaM	
prasaBa		balAwkAraM^hiMsa	
prasafga		prasafgaM^saMxarBaM	
prasanna		prasannaM^nirmalaM	
pravqwwa		prAraMBiMpabadinaxi^niScayiMpabadinaxi	
pravqwwi		AraMBaM^svaBAvaM	
pravyaWiwa		pIdimMpabadinavAdu	
anwar		lopala^naduma	
prawApa		prawApaM^wejassu^vedi	
prawi		samAnaM^mAru	
upakAra		upakAraM^melu	
prawiRTA		prawiRTa^gOravamu	
prawiRTiwA		prawiRTiMpabadinaxi^sWiramEnaxi	
prawiRTiwa		prawiRTiMpabadinaxi^sWiramEnaxi	
prawi_jFA2			
prawi_pax1			
prawi_sWA1_Nic			
prawi_yuXa1			
prawyakRa		prawyakRaM^kanipiMcunaxi^kalYlYa_eVxuru	
avagama		samIpiMcu^welusukonuta	
prawyanIka		Sawruvu^viroXi	
prawyavAya		avaroXaM^pApaM^kRINiMcuta	
prayANa		prayANaM	
prayAwa		canipovuta^velYlYipovuta^AkramiMcuta	
prayawa		jiweMxrudu^Xarmikudu	
prayawna		prayawnaM	
prewa		maraNiMcinavAdu^piSAcamu	
priyA		priya^priyurAlu	
priya		priya^priyurAlu	
cikIrRu		ceyavaleVnani_icca_kalavAdu	
kqwwama		mukkalu_ceyataM	
priya-wara		aXika_prema	
puNya		puNyaM	
puR3			
puRkalA		puRkalaM^aXikaM^SreRTaM^saMqxXaM	
puRpa		puRpaM^pUvu^kusumaM	
puRpiwA		pUcinaxi^wIga^vqkRaM	
pumaw			*
pums			*
punaH		punaH^malYlYi	
punarAvarwin		malYlYi_janmiMcuvAdu	
punarjanman		xvijanma^punarjanma^malYlYi_puttuta	
purA		pUrvaM^pUrva_kAlaM	
purANI		puramulu^nagaramulu	
purANa		purANaM^purAwana^prAcIna	
purAwana		purAwanaM	
pura		puramu^nagaramu	
puraswAw		muMxu^wUrpu^eVxuta^gawa_kAlaM	
puroXas		purohiwudu	
puruRa		puruRudu	
vyAGra		vyAGramu^puli	
puruRarRaBa		SreRTa_puruRudu	
puruRowwama		puruRowwamudu	
purujiw		purujiwwudu	
puwra		puwrudu	
gqha		gqhaM^illu	
xAra		Barya	
q1			
qRi		qRi	
qX1			
qk		swuwi^praSaMsa^pUja^qigvexa	
qwa		pUjiMpabadunaxi^sawyamu	
qwe		pUjiMpabadunaxi^sawyamu	
qwu		qwuvu	
rAgAwmaka		rAgAwmakaM^anurAgaM_kaliginaxi	
xveRa		xveRaM	
rAga		rAgamu^anurAgamu	
viyukwa		veruceyabadina	
rAgin		anurakwudu^rAgamu_kalavAdu	
rAjan		rAju	
guhya		gupwamu^rahasyaM	
rAjasI		rajoguNa_saMbaMXinI	
rAjasa		rajoguNa_saMbaMXiwa^rAju_saMbaMXiwa^wejassu	
rAjya		rAjyaM	
rAkRasI		rAkRasi	
rAma		SrI_rAmudu^priyaM^manoharaM^AnaMxapraxa	
rAwri		rAwri	
rUpa		rUpaM	
raNa		raNaM^yuxXaM^saMgrAmaM^samaraM	
samuxyama		pEki_leputa^samAraMBaM	
raWa		raWaM	
upasWa		maXya_Bagamu	
rahas		ekAMwamu	
rahasya		rahasyaM	
rakRas		rAkRasudu	
ram1			
rasAwmaka		rasAwmakaM^sAravaMwaM	
rasa		sAraM	
varja		vidupu^vaxuluta	
rasana		nAluka^ruci	
rasya		sAravaMwaM^rucikaraM	
ravi		sUryudu	
rawa		prasannaM^anurAgaM	
ripu		Sawruvu	
roma		romamu^veVtruka	
harRaNa		harRaM	
roman		romamu^veVtruka	
harRaNa		harRaM	
ruX1			
ruXira-pra_xih1			
ruxra		ruxra^BayAnaka^Bayafkara	
sAXarmya		samAnawa	
sAXu		uwwamaM^SreRTaM	
sAXya		sAXyaM^ceyaxaginaxi	
sAfKya		safKyA_saMbaMxiwa^sAfKya_xarSanaM	
sAgara		sAgaraM^samuxraM	
sAkRAw		sAkRAwwu^eVxuta^kalYlYamuMxunnaxi	
sAkRin		sAkRi^cUcinavAdu	
sAmAsika		samAsa_saMbaMXa^sAmUhika	
sAman		saMwoRaM_kaligiMcunaxi^sAmavexaM	
sAmarWya		sAmarWyaM	
sAmavexa		sAmavexaM	
sAmya		samAnaM^samawvaM	
sAwwvikI		sawva_guNaM_kalaxi	
sAwwvika		sawva_guNaM_kalavAdu	
sAwyaki		sAwyaki	
sEnya		sEnyaM	
sOBaxra		sOBaxrudu^suBaxruni_koduku	
sOkRmya		sUkRmamu	
sOmaxawwi		sOmaxawwudu	
sOmya		sOmya^mqxuwvaM^suMxaraM^SuBaM^	
vapus		SarIraM^xehaM	
sOmyawva		sOmyawa	
sU2			
sUkRmawva		sUkRmawvaM	
sUrya		sUryudu	
sahasra		sahasraM^veyi	
sUwa		sAraWi^sUwudu	
sUwra		sUwramu^xAramu^safkRipwa_viXi	
sWA1			
sWA1_Nic			
sWANu		XqDa^sWira	
sWAna		sWAnaM^sWiwi^nivAsaM	
sWAvara		sWAvaraM^kaxalanixi	
jafgama		jIviwa^wirugunaxi	
sWErya		sWEryaM^XqDawvaM^sWirawvaM	
sWirA		sWiraM	
sWira		sWiraM	
sWiwi		parisWiwi^sWiwi	
sa			
Sara			
sa-aXi-BUwa-aXi-xEva			
sa-aXi-yajFa			
sa-ahafkAra			
sa-cewas			
sa-gaxgaxa			
sa-vijFAna			
sa-vikAra			
sa-xoRa			
saFjanayaw			*
saFjaya		peru	
saKa		miwrudu^sakudu	
saKi		saKi^celiya	
saMSaya		saMSayaM^saMxehaM	
saMSiwa		wejassu^wIkRNaM	
vrawa		vrawaM^prawijFA^niyamaM	
saMSuxXa		SuxXi_ceyuta	
saMsAra		saMsAraM^mArgaM^lOkika_jIviwaM	
saMsixXi		pUrNamu^svaBAvamu	
saMsparSa		cakkani_sparSa	
saMvAxa		saMvAxaM^carca	
saMyama		niyaMwraNa	
saMyamin		niyaMwriMcuvAdu	
saMyawa		kattabadinaxi^baMXiMpabadinaxi	
sac2			
sacarAcara		prapaMcaM	
safGAwa		samuxAyaM^samUhamu	
safKya		safKya^aMkeV	
safga		safgaM^sahavAsaM^kUduta	
rahiwa		rahiwa^viduvabadinaxi	
varjiwa		wyakwa	
vivarjiwa		wyakwa	
safgrAma		safgrAmaM^yuxXaM^kalahaM^poru	
safgraha		safgraha^safkRipwa^sekariMcu	
safkara		safkara_jAwi^kUdika	
saha		orpu_unnavAdu^sahiwamu^Sakwi^sAmarWyaM	
saha1			
sahaja		sahajaM	
sahasA		akasmAwwu^balavaMwaMgA	
sahasra		sahasraM^veyi	
yuga		yugaM	
paryanwa		paryaMwaM^varaku	
sahasraSaH		veyi^sahasraM	
sahasrakqwvas			*
sahaxeva		sahadevudu	
sakwa		Asakwudu^vyasanaparudu	
samA-hq1			
samAXi		samAXi^ekAgrawa^wapassu	
samAramBa		AramBaM	
samAsa		samAsaM	
samBava		saMBavaM^puttuka	
sam_Af_XA1			
sam_Af_car1			
sam_Af_gam1			
sam_Ap1			
sam_BU1			
sam_BU1_Nic			
sam_IkR1			
sam_Sri1			
sam_aXi_gam1			
sam_ava_sWA1			
sam_awi_i1			
sam_hq1			
sam_jan3			
sam_ji1			
sam_ni_as1			
sam_ni_viR2			
sam_ni_yam1			
sam_pax1			
sam_pra_IkR1			
sam_pra_kQw1			
sam_pra_vqw1			
sam_smq1			
sam_swamB1			
sam_upa_Af_Sri1			
sam_upa_sWA1			
sam_vqw1			
sam_wQ1			
sam_wuR1			
sam_xqS1			
sam_yA1			
sam_yam1			
sam_yam3			
sam_yam3_Nic			
sama		samAnaM^samaswaM	
ciwwawva		manassu	*
loRta		matti_gadda	
aSman		rAyi^meGaM	
kAFcana		koMceM	
xarSana		cUpiMcadaM	
samagra		samaswaM^samagraM	
samam		samaM^samAnaM	
samanwAw		aMwatA^viSva_vyApi	
samanwawaH		aMwata	
samavewa		kUdi_uMduta^kalisi_unnaxi	
samawA		samawvaM^samawA	
samawIwa		pUrvakAlamu	
samawva		samaBAvamu	
samaxarSin		samaxqRti_kalavAdu^wawva_jFAni	
sambanXin		saMbaMXaM_kalavAdu	
samiwiFjaya		yuxXamaMxu_vijayudu	
samixXa		SuxXaM^prakASiwaM	
sammoha		prema^AkarRaNa^mUrKawA	
sammuKa		aBimuKaM^exuru	
sampaSyaw			*
sampax		saMpaxa	
sampluwoxaka		varaxa	
samprawiRTA		saMprawiRTa^unnawa_sWiwi	
samqxXa		samqxXi^aBivqxXi^saMpaxa	
vega		vegaM^vadi^wvariwaM	
samuxXarwq		mukwi_xAwa	
samuxra		samuxraM^kadali^sAgaraM	
samyak		cakkagA^maMcixi^yukwamugA	
sanAwana		sanAwanaM^prAcInaM^SaSvawaM	
sannyAsa		sannyAsaM	
yukwa		yukwaM^waginaxi	
sannyAsin		sannyAsI	
sannyasana		sannyasiMcadaM^wyAgaM^vErAgyaM	
sanwa		aMjali	*
sapawna		Sawruvu^viroXi	
sapwan		sapwa^edu	
saras		sarassu	
sarga			*
sarpa		sarpamu^pAmu^gamanaM^anusaraNaM	
sarvA		sarvaM	
sarva		sarvaM	
AScaryamaya		AScaryamayaM	
AramBa		AraMBaM	
sarva-BAva		BAvaM	
sarva-BUwa		prANi^upalabXa^uwpanna	
sarva-BUwa-ASaya-sWA1			
hara			*
ABAsa		prakASaM	
sarva-inxriya-vi_vqj3			
vqkRa		vqkRaM	
xehin		prANi^xehamu_kalavAdu	
xurga		xurgaM^kota^vipawwi^guHKaM	*
sarvaSaH		aMwata^paripUrNaMgA	
sarvaWA		anni_viXamulugA	
sarvawaH		annivEpulanuMdi	
Sruwimaw		vinikidi	
akRi		newramu^kannu	
Siras		Sirassu	
muKa		muKaM	
pANi		pANi^ceyi	
pAxa		pAxamu	
sarvawra		aMwata	
ga			*
sasj1			
savyasAcin		arjunudu	
saw		yaWArWaM^pAvanaM^maMci	
sawawa-yuj2			
sawawam		eVllappudu^niraMwaraM^	
sawkAra		sawkAraM	
mAna		mAnamu	
sawwva		sawva_guNaM^sawwa^balaM	
anurUpA		anurUpamu^anuguNamu^samAnamEna	
sawwva-sam_Af_viR2			
sawwvavaw		sawwva_guNamu	
sawya		sawyaM	
sax-BAva		sawBAvamu	
sax		uwwamamEna^sawyaM	
asax		xuRtudu^nijamu_kAnixi	
yoni		garBASayamu	
janman		uwpawwi^puttuka	
sax1			
saxA		saxA^eVllapudu	
saxqSI		samAnamu	
saxqSa		samAnamu	
senA		sena^sEnyamu	
senAnin		nAyakudu	
sev1			
sevA		seva	
siMhanAxa		siMhanAxaM	
siX3			
sixXa		sixXiMcina	
sixXi		sixXi^neVraveruta	
asixXi		asaMpUrNamu	
skanxa		kumAra_svAmi	
sma		BUwakAlamunu_nirxeSiMcunaxi	*
smq1			
smqwi		smaraNa	
BraMSa		naSiMcuta^kriMxapaduta	
viBrama		BrAMwi^AScaryamu	
snigXa		snehiwudu^snehiwa	
soma		soma_yAga^amqwaM	
soma-pA		somapAnaM_ceyuvAdu	
sparSa		sparSa	
sparSana		vAyuvu^sparSa	
spqS1			
spqhA		uwsukawa^icCA	
sqj2			
sqwi		mArgaM	
sraMs1			
sru1_Nic			
su-virUDa		aMkuriMcina^uwpannamEna	
mUla		mUlamu^moVxalu^kAraNamu	
su-xur-xarSa		xuraxqRtamu	*
su-xurAcAra		xurAcAramu	*
su-xurlaBa		xurlaBamu	
suGoRa		GoRa	
maNipuRpaka		maNipuRpakamu^sahaxevuni^SafKamu	
suKa		suKamu	
suKin		suKamu_kalavAdu	
suhqx		snehiwudu	
ari		Sawruvu	
uxAsIna		uxAsInamu^Asakwi_lekapovuta	
maXyasWa		maXyavarwi	
xveRya		Sawruvu	
banXu		banXuvu	
sukqw		puNyAwmudu^XArmikudu	
sukqwa		puNyaM^SuBa_kAryaM	
xuRkqwa		xuRtudu	
sukqwin		paropakAri	
sulaBa		sulaBaM^sulaBamugA_laBiMcunaxi	
suniSciwa		buxXimaMwudu	
sura		xevawa^sUryudu^jFAnavaMwudu	
susuKa		sOKyamu_kalaxi	
suxuRkara			*
svA			*
svAXyAya		svAXyAyamu^vexAXyayanamu	
aByasana		aByAsamu	
sva		sva^wana	
anuRTiwa		Acariwamu	
sva-bAnXava		baMXuvu	
cakRus		kannu^newraM	
jana		janaM	
nirawa		nirawamu	
wejas		wejassu	
svaBAva		svaBAvamu	
svaBAva-jA			*
svaBAva-ja			*
niyawa		niwyaM^niSciwaM	
praBava		praBAvaM	
svaXA		svaXA^Ahuwi	
svaXarma		svaXarmaM	
svaka		wanaxi^wanavAdu	
svalpa		svalpaM	
svap1			
svapna		svapnaM^kala	
svar		SabxaM_ceyuta	
svarga		svargaM	
xvAra		xvAraM	
svasWa		ArogyavaMwudu	
svaswi		kRemaM^SuBaM^maMgalYaM	
svayam		savayaM	
swabXa		swaMBiMcuta	
swamB1			
swena		xoVMga	
swrI		swrI	
swu1			
swuwi		swuwi	
syanxana		raWaM	
uBa		reVMdu	
uBaya		uBayamu^reVMdu	
viBraRta		BraRtudu^kRINiMcinavAdu	
uRma-pA			*
uSanA		SukrAcAryudu	
ucCiRta		eVMgili	
ucCoRaNa		eVMdipovuta	
uccEHSravasa		poVdugu_ceVvulu_kalavAdu	*
ucca		unnawaM	
ugrA		ugramu^BayaMkara	
ugra		ugramu^BayaMkara	
ulba		garBASaya	
upAyawaH		samIpiMcuta	*
upa_Af_Sri1			
upa_As1			
upa_Sri1			
upa_Xq1_Nic			
upa_han1			
upa_hu1			
upa_i1			
upa_jan2			
upa_jan3			
upa_laB1			
upa_lip1			
upa_pax1			
upa_ram1			
upa_sam_gam1			
upa_sev1			
upa_viS1			
upa_xiS1			
upa_xqS1			
upa_yA1			
upamA		polika	
uraga		sarpamu^pAmu	
uw_Af_hq1			
uw_hq1			
uw_kram1			
uw_miR1			
uw_sax1			
uw_sqj2			
uwa		vikalpamu	
uwsanna		naSiMcuvAdu	
uwwamOjas		prakASamu^wejassu	
uwwarAyaNa		uwwrAyaNamu	
ux		unnawamu	
sAxana		aByAsaM	
uxAra		uxAra^xAna_SIlawa	
uxAsIna		watasWaM	
uxAsInavaw			*
uxBava		uxBaviMcuta	
ux_sWA1			
ux_vij2			
ux_xiS1			
ux_yam1			
ux_yam2			
uxan-pAna		pAna_pAwra	
uxxeSa		uxxeSaM^BAvaM	
vA		vikalpamu	
vAc		vAkku^sarasvawi	
vAfmaya		vAfmayaM^BARA	
vAkya		vAkyaM	
vArRNeya		vArRNeyudu^SrIkqRNa	
vAsa		nivAsaM	
vAsas		vaswraM	
vAsava		iMxrudu	
vAsuki		vAsuki^nAga_rAju	
vAsuxeva		vAsudevudu^SrIkqRNudu	
vAxa		vAxana	
vAxin		vakwa	
vAyu		vAyuvu	
vESvAnara		agni^vESvAnarudu	
vESya		vESyudu	
vEnaweya		vEnaweyudu	
vErAgya		vErAgyaM^virakwi	
vErin		Sawruvu	
vIryavaw		parAkramaM	
vIwa-rAga		virakwudu	
vIwa-rAga-Baya-kroXa		poyinaxi	
vaSa		vaSaM	
vaSin		jiweMxriyudu	
vaSya		vaSamEnaxi	
vac1			
vacana		vacanaM	
vacas		vacanaM	
vah1			
vahni		agni	
vajra		vajrAyuXaM^vajraM	
vakwra		muKaM	
kAraka		karwa^	
varRa		varRaM^saMvawsaraM	
vara		varaM	
varuNa		varuNa_xevudu	
varwamAna		varwamAnaM	
varwman		mArgaM	
vas1			
vasu			*
vax1			
vaxana		vaxanaM	
vega		vegaM	
vep1			
vepaWu		kaMpanaM	
vewwq		welisinavAdu^pawi^qRi	
vexAnwa		vexAnwaM	
vexa		vexaM	
nivqwwa		niReXamu	
viBAvasu		prakASaM^sUryudu	
viBUwi		Sakwi	
viBUwimaw		Sakwi	
viBu		SakwivaMwudu	
viRAxa		viRAxamu	
viRAxin		xuHKiMcuvAdu	
viRNu		viRNuvu	
viRa		viRaM	
viRama		viruxXamu	
viRaya		viRayamu	
pravAla		ciguru^pagadamu	
viS1			
viSAla		viSAlaM	
viSiRta		viSiRtaM	
viSuxXA		svacCaM^nirmalaM	
viSva		viSvaM	
viSvawaH		annivEpulanuMdi	
viSveSvara		ViSveSvarudu^Sivudu	
viXAna-vac1			
viXeya		vinayamu^viXeyaM	
hIna		hIna	
viXi-xqS1			
vi_Af_hq1			
vi_Ap1			
vi_Baj1			
vi_IkR1			
vi_Nax2			
vi_SAs1			
vi_XA1			
vi_XI1			
vi_anu_nax2			
vi_apa_Af_Sri1			
vi_ava_sWA1			
vi_ava_si1			
vi_awi_i1			
vi_awi_wQ1			
vi_cal1_Nic			
vi_gam1			
vi_hA2			
vi_jFA1			
vi_jFA2			
vi_kamp1			
vi_laj2			
vi_mqS1			
vi_muc1			
vi_muh1			
vi_muh1_Nic			
vi_naS1			
vi_ni_vqw1			
vi_ni_yam2			
vi_pari_vqw1			
vi_sWA1			
vi_sax1			
vi_smi1			
vi_sqj2			
vi_swamB1			
vi_uw_as2			
vi_vqX1			
vi_xQ2_Nic			
vicakRaNa		vicakRaNa	
vicewas		manovEkalyaM	
vigawa		lopiMcinaxi	
BI		Bayamu	
jvara		jvaraM	
spqha		korika	
viguNa		guNa_hInudu	
vihAra		vihariMcuta^wota	
SayyA		padaka^maMcamu	
Asana		Asanamu^pIta	
Bojana		Bojanamu	
vijFAna		vijFAnaM	
sahiwa		wo	
vijaya		vijayaM	
vijiwa		jayiMpabaddavAdu	
vikAra		vikAraM^rogaM^apahAsyaM	
vikarNa		vikarNudu	
vikarman		virixXaMgA_AcariMcuvAdu	
vikrAnwa		vikrAMwudu^vIrudu	
vimUDa		mUrKudu	
vimawsara		IrRya_lenivAdu	
vimokRa		mukwi^mokRaM	
vinA		lekuMda	
vinASa		vinASanaM	
viniSciwa		niScayiMpabadina	
viniyawa		niyaMwriMcabadina	
vipaSciw		paMdiwudu^vixvAMsudu	
viparIwa		viruxXamu	
virAta		virAta_rAju	
visarga		visarjanamu	
vismaya		vismayamu	
vismaya-Af_viR2			
viswAra		viswAramu	
viswara		viswaraNaM	
viswaraSaH		viswaraNaM	
vivasvaw		sUryudu	
viviXA		viviXa	
viviXa		viviXa	
vivikwa		viBinnamu	
sevin		seviMcuvAdu	
seviwva		seviMcabadina	
viwweSa		kuberudu	
vix1			
vix2			
vix3			
vixiwa		paMdiwudu	
vixvas		vixvAMsudu	
vixyA		vixya	
vinaya		vinayudu	
sampanna		sampannudu	
vqRNi		gollavAdu^kqRNudu	
vqjina		pApamu	
vqkoxara		vqkoxarudu^Bimudu	
vqw1			
vqwa1			
vraj1			
vyAmiSra		kalupabadina	
vyAsa		vyAsudu	
prasAxa		prasAxaM^anugrahaM	
vyAwa-Anana			*
vyUDA		vyUDaM	
vyUDa		vyUDaM	
vyaW1			
vyaW1_Nic			
vyaWA		vyaWa	
vyakwa		vyakwamaguta^spaRtamaguta	
maXya		maXya	
vyakwi		vyakwi	
vyapewa		vidipovuta	
vyavasAya		vyavasAyaM	
vyavasWiwa		viXiMpabadina	
wAmasI		cIkati^rAwri	
wAmasa		cIkati^alasawvaM	
wAvaw		avaXi	
wAwa		waMdri	
wQ1			
wURNIm		minnakuMduta	
waWA		alAga	
waWApi			*
waWEva			*
wamas		cIkati	
wan1			
wanu		wanuvu	
wap1			
wapas		wapassu	
wapasvin		wapasvi	
wapasya		wapassu	
warhi			
wasmAw			
wawa			
wawaH			
wawpara			
wawra		akkada	
wawwva		wawwvaM	
xarSana		xarSana	
xarSin		xarSiMcuvAdu	*
wawwvavix		wawwva_jFAni	
wawwvawaH			*
wax		axi	
BAviwa		poMxabadina	
arWIya		aBiprAyaM_kalavAdu	
arWa		arWa	
buxXi		buxXi	
niRTA		niRTa	
parAyaNA		parAyaNudu^AsakwikalavAdu	
samakRa		samakRaM	
waxA		appudu	
waxananwaram		waxananwaraM^AwaruvAwa	
waxsarvanAma			
waxvaw			
wejas		wejassu	
wejas-aMSa-sam_BU1			
rASi		samUhamu	
wejasvin		wejasvi	
wejomaya		wejomayaM	
wij1			
woya		nIru	
wqRNA		wqRNa^xappika^icCa	
wqpwi		wqpwi	
wrE1			
wrEguNya		wrRguNya^wriguNamula	
wrElokya		wrElokya^wrilokamula	
wrEvixya		wrivixya	
wrayI		mUdu_vexamulu	
wraya		mUdu	
wri		mUdu	
wriXA		mUdu_viXamulu	
wriviXA		mUdu_viXamulu	
wriviXa		mUdu_viXamulu	
wu		kAni	*
wuR1			
wuRti		saMwoRamu	
wulya		samAnamu	
saMswuwi		swuwi	
ninxA		niMxa	
apriya		apriyaM	
wumula		BayaMkara	
wvac		wolu	
wvar1			
wvaw		nIxi	*
wvawwaH			
wvax		nIxi	*
sama		samamu	
wyAga		wyAgaM	
Pala		PalaM	
wyAgin		wyAgi	
wyaj1			
wyakwa		viduvabadinaxi	
parigraha		svIkariMcuta	
xA3			
xAkRya		kOSalamu^nerpu	
xAna		xAnamu	
xAnava		xAnavudu^rAkRasudu	
xEvI		xevawA_saMbaMXiwa	
xEva		xevawA_saMbaMXiwa	
xEwya		rAkRasa	
xIp1			
xIpa		xIpaM	
xIpwa		prakASiMpabadunaxi	
anala		agni^jaTarAgni	
arka		sUrya_kAMwi	
xyuwi		kAMwi^veVlugu	
huwASa		agni	
vakwra		muKaM	
xIpwimaw		prakAsiMcunaxi	
xIrGasUwrin		somari	
xUra		xUraM	
xUreNa		xUraM	
xaMRtrA		kora_palYlYu	
karAla		BayaMkara	
xaNda		karra	
xaSan		paxi	
xaSana		palYlYu	
xah1			
xakRa		samarWudu^nipuNudu	
xakRiNAyana		xakRiNAyanaM	
xam1_Nic			
xamBa		kapatamu	
xamBa-ahafkAra-sam_yuj2			
xama		nigrahiMcuta^xaNdana	
xarSana		xarSanaM	
kAfkRin		kAfkRiMcuvAdu	
xarpa		xarpamu^ahaMkAraM^garvaM	
xayA		xaya	
xeSa		xeSaM	
xehAnwara			*
prApwi		prApwi^poMxu^laBiMcu	
xeha		xehamu^SarIraM	
Bqw		baMtu^kUli	
xehavax		xehamu^SarIraM	
xehin		AwmA^xehaM_kalaxi	
xeva		xeva	
Boga		Bogamu^suKamu	
qRi		qRi	
vara		varamu^SreRtamu	
vrawa		vrawamu^nomu	
xvija		reMdusArlu_puttinavAdu	
prAjFa		buxXi	
pUjana		pUjiMcuta^gOraviMcuta	
yajas		yajurvedaM	*
xevala			*
xevawA		xevawa	
xevaxawwa		xevawa	*
xeveSa			*
xiS		xikku	
xiv		xinamu	*
xivya		xivya	
xivya-aneka-uxyawa-AyuXa			
xivya-ganXa-anulepana			
xivya-mAlya-ambara-Xara			
xoRa		xoRamu	
xoRavaw		xoRamu	
xqDa		xqDamu	
xqRta		cUdabadina	
xqRti		cUdabadina	
xqRtq			*
xqS1			
xqS1_Nic			
xrOpaxeya		xrOpaxeyudu	
xravya		xravyaM	
xravyamaya		xravyaM	*
xroNa		xrONudu	
xru1			
xrupaxa		xrupaxudu	
puwra		puwrudu	
xuHKa		xuHKamu	
Alaya		AlayaM^nivAsaM	
Amaya		rogamu	
praxa		xAwa	
han		vaXiMcuta	
viyoga		viyogaM	
xuHKawara		xuHKamu	
xuRkqw		xuRta	
xuRkqwin		xuRtudu	
xuRpUra		xuRtudu	
xuRtA		xuRta	
xur-gawi		xurgawi	
xur-mawi		xurbuxXi	
xur-meXas		xurbuxXi	
xur-nigraha			*
xur-nir_IkR1			
xurAsaxa			
xurawyayA			
xurbuxXi		xurbuxXi	
xurlaBawara		xurlaBaM	
xuryoXana		xuryoXanudu	
xus_pra_Ap1			
xvAra		xvAraM	
xvanxva		xvanxva	
moha		mohamu	
awIwa		awIwamu	
xvanxva-moha-nir_muc1			
xveRa		xveRaM	
xveRya		xveRaM	
xvi		xvi^reMdu	
xviR1			
xviviXA		reMdu_viXamulu	
xyAvA			*
xyUwa		jUxamu	
yA1			
yAvaw			
yAwa		prayANaM	
yAma		jAmu	
yAxas		jalajaMwuvu	
yAxava		yAxavudu	
yAxqS		eVtuvaMtixi	
yOvana		yOvvanam	
yaSas		yaSassu	
yaWA		e_viXamugA	
BAga		BAgamu	
yaWAvaw		yaWAviXi	
yaj1			
yajFa		yajFamu	
amqwa		amqwaM	
SiRtA		viSiRtudu	
aSin		ciraMjIvi	*
Buja		Bujamu	
kRapiwa		naSiMcina	
kalmaRa		kalmaRaM	
yajFavix		yAgaviXi_welisinavAdu	
yajus		yajurvedaM	
yakRa		yakRudu	
rakRas		rAkRasudu	
yama		yamudu^yamaXarma_rAju	
yanwra-Af_ruh1			
yasmAw		eVvarinuMdEwe	
yaw		exEwe	
yaw1			
yawa		prayawniMcuta^niyaMwriwa	
yawaH		eVMxukaMte	
yawi		sAXuvu^prayawniMcuta	*
yawra		eVkkadEwe	
yax		exEwe	
praBAva		praBAvaM	
vikArin		mArpu_ceMxunaxi	
yaxA		eVppudEwe	
yaxi			*
yaxqcCA		yaWecCaM	
sanwuRta		sanwuRtudu^wqpwi_kalginavAdu	
yaxvA		ixi_kAkuMte_axi	
yaxvaw		ixi_kAkuMte_axi	
yaxyapi		ayinAkUdA	
yoXa		yoXudu	
muKya		muKyudu	
vIra		vIrudu	
yoga		yoga	
ArUDa		eVkkinavAdu	
BraRta		BraRtudu	
XAraNA		XariMcuta	
bala		balaM	
kRema		kRemaM	
saFjFiwa		peru_galaxi	
viwwama		vixvAMsudu	
yogamAyA		yoga_mAya^viRNu_mAya	
yogeSvara		yogeSvarudu	
yogin		yogi	
yoni		yoni^garBASayaM	
yowsyamAna			*
yoxXu-kAma			*
yuRmax		nI^nIvu	
yuX		yuxXaM^yuxXam_ceyuta	
yuX1			
yuXAmanyu		yuXAmanyudu	
yuXiRTira		yuXiRTirudu	
yuga		yugamu	
yugapaw		eka_kAlamuna^oVke_sAri	
yuj1			
yuj2			
yukwa		kUdukunnaxi^yogyamEnaxi	
avaboXa		melukoVlputa^nerpiMcuta	
yukwa-wama		yogyamEnaxi	*
yukwaceRta		maMci_pravarwana	
yukwacewas		maMci_pravarwana	*
yukwawama		yogyamEnaxi	
yuxXa		yuxXaM	
viSAraxa		paMdiwudu^vixvAMsudu	
yuyuXAna		yuyuXAnudu	
yuyuwsu		yuyuwsudu	
